	en	fr	es
name	English	Français	Español
navbar_analysis	Analysis	Analyse	Análisis
navbar_keyframes	Keyframes	Images clés	Imágenes claves
navbar_thumbnails	Thumbnails	Imagettes	Miniaturas
navbar_twitter	Tw. search	Recherche Tw.	Búsqueda Tw.
navbar_magnifier	Magnifier	Loupe	Lupa
navbar_metadata	Metadata	Metadonnées	Metadatos
navbar_rights	Video rights	Droits vidéo	Derechos video
navbar_forensic	Forensic	Forensic	Forensic
navbar_about	About	A propos	Sobre nosotros
navbar_survey	Survey	Questionnaire	Cuestionario
navbar_tuto	Tutorial	Tutoriel	Tutorial
button_submit	Submit	Soumettre	Enviar
button_download	Download	Télécharger	Descargar
button_apply	Apply	Appliquer	Aplicar
button_undo	Undo	Annuler	Anular
button_redo	Redo	Refaire	Volver a hacer
button_localfile	Local file	Fichier local	Fichero local
button_reverse_google	Google Image reverse search	Recherche inversée Google image	Búsqueda inversa de imagen Google
button_reverse_yandex	Yandex Image reverse search	Recherche inversée Yandex image	Búsqueda inversa de imagen Yandex
button_reverse_tineye	Tineye Image reverse search	Recherche inversée Tineye	Búsqueda inversa de imagen Tineye
button_reverse_twitter	Twitter video search	Recherche sur Twitter	Búsqueda en Twitter
api_title	Video contextual verification	Vérification du contexte de la vidéo	Verificación del contexto del video
api_repro	Reprocess	Retraiter	Volver a procesar
api_comments	Verification comments	Commentaires de vérification	Comentarios de verificación
api_map	Map	Carte	Mapa
api_input	Copy and paste a Youtube, Facebook or Twitter url	Copier et coller une adresse YouTube, Facebook ou Twitter	Copiar y pegar un enlace de YouTube, Facebook o Twitter
api_searchbox	Search box	Rechercher	Buscar
youtube_video_title	Video:	Vidéo:	Video:
youtube_video_name1_1	Video title	Titre de la vidéo	Titular del video
youtube_video_name1_2	Video description	Description de la vidéo	Descripción del video
youtube_video_name2_1	Video view count	Nombre de vues	Número de vistas
youtube_video_name2_2	Like count	Nombre de "j'aime"	Número de "me gusta"
youtube_video_name2_3	Dislike count	Nombre de "je n'aime pas"	Número de "no me gusta"
youtube_video_name2_4	Duration	Durée	Duración
youtube_video_name2_5	Licensed content	Contenu sous license	Contenido bajo licencia
youtube_video_name2_6	Description mentioned locations	Lieux dans la description	Lugares en la descripción
youtube_video_name2_7	Recording location description	Lieu de l'enregistrement	Lugar de la grabación
youtube_video_name2_8	Upload time	Date de mise en ligne	Fecha de puesta en línea 
youtube_channel_title	Channel:	Chaîne:	Cadena:
youtube_channel_name_1	Channel description	Description de la chaîne	Descripción de la cadena
youtube_channel_name_2	Channel created time	Date de la création de la chaîne	Fecha de la creación de la cadena
youtube_channel_name_3	Channel view count	Nombre de vues de la chaine	Número de vistas de la cadena
youtube_channel_name_4	Channel page	Page de la chaîne	Página de la cadena
youtube_channel_name_5	Channel location	Localisation de la chaîne	Localización de la cadena
youtube_comment_title	Comments	Commentaires sur la vidéo:	Comentarios sobre el video
youtube_comment_name_1	Video comment count	Nombre de commentaires	Número de comentarios
youtube_comment_name_2	Number verification comments	Nbre de com. pour vérification	Número de comentarios para verificación
facebook_video_title	Video:	Vidéo:	Video:
facebook_video_name_1	Video id	Identifiant de la vidéo	Identificación del video 
facebook_video_name_2	Video title	Titre de la vidéo	Títular del video
facebook_video_name_3	Duration	Durée	Duración
facebook_video_name_4	Content category	Catégorie du contenu	Categoría del contenido
facebook_video_name_5	Content tags	Tag du contenu	Tag del contenido
facebook_video_name_6	Video description	Description de la vidéo	Descripción del video
facebook_video_name_7	Like count	Nombre de "j'aime"	Número de "me gusta"
facebook_video_name_8	Updated time	Date de mise en ligne	Fecha de puesta en línea 
facebook_video_name_9	Created time	Date de création	Fecha de creación
facebook_page_title	Details:	Détails:	Detalles:
facebook_page_name_1	Page	Page	Página
facebook_page_name_2	Description mentioned locations	Lieux dans la description	Lugares en la descripción
facebook_page_name_3	Privacy	Confidentialité	Confidencialidad
facebook_page_name_4	Embeddable	Incorporé YouTube	Integrable
facebook_page_name_5	Facebook type	Type Facebook	Tipo Facebook
facebook_comment_title	Comments	Commentaires sur la vidéo	Comentarios
facebook_comment_name_1	Video comment count	Nbre de commentaires	Comentarios sobre el video
facebook_comment_name_2	Number verification comments	Nbre de commentaires vérifiés	Número de comentarios verificados
twitter_video_title	Video	Vidéo	Video
twitter_video_name_1	Identifiant	Identifiant	Identificador
twitter_video_name_2	Content	Contenu	Contenido
twitter_video_name_3	Origin	Origine	Origen
twitter_video_name_4	Likes count	Nombre de "j'aime"	Número de "me gusta"
twitter_video_name_5	Retweets count	Nombre de retweets	Número de retweets
twitter_video_name_6	Hashtags	Hashtags	Hashtags
twitter_video_name_7	Urls included	Urls incluses	Urls incluidas
twitter_video_name_8	Mentionned by	Mentionné par	Mencionado por
twitter_video_name_9	Language	Langue	Lengua
twitter_video_name_10	Thumbnail	Imagette	Miniaturas
twitter_video_name_11	Size	Taille	Talla
twitter_video_name_12	Duration	Durée	Duración
twitter_video_name_13	Locations mentioned	Lieux mentionnés	Lugares mencionados
twitter_video_name_14	Embedded YouTube	Incorporé de YouTube	Integrable desde YouTube
twitter_video_name_15	Created	Date de création	Fecha de creación
twitter_video_name_16	Video	Vidéo	Video
twitter_user_title	User	Utilisateur	Usuario
twitter_user_name_1	Name	Nom	Nombre
twitter_user_name_2	Screen name	Pseudonyme	Nombre de usuario
twitter_user_name_3	Location	Localisation	Lugar
twitter_user_name_4	Profile	Profil	Perfil
twitter_user_name_5	Description	Description	Descripción
twitter_user_name_6	Protected user	Utilisateur protégé	Usuario protegido
twitter_user_name_7	Verified user	Utilisateur vérifié	Usuario verificado
twitter_user_name_8	Followers	Nombre d'abonnés	Seguidores
twitter_user_name_9	Following	Nombre d'abonnements	Seguidos
twitter_user_name_10	Lists	Listes	Listas
twitter_user_name_11	Tweets liked	Tweets "aimés"	Tweets "likeados" 
twitter_user_name_12	Tweets count	Nombre de tweets	Número de tweets
twitter_user_name_13	Created	Date de création	Fecha de creación
twitter_user_name_14	User language	Langue de l'utilisateur	Idioma de usuario
twitter_user_name_15	Locations mentioned	Lieux mentionnés	Lugares mencionados
error_video_download_failed	Video download failed. Try with another video.	Le téléchargement de la vidéo a échoué. Veuillez essayer avec une autre vidéo.	La descarga del video falló. Inténtalo con otro video.
error_video_download_timeout	Video download failed. The video download has timed out.	Le téléchargement de la vidéo a échoué. La vidéo a mis trop de temps à télécharger.	La descarga del video falló. Se agotó el tiempor de la descarga 
error_video_segmentation_failed	Video segmentation analysis failed.	L'analyse de segmentation vidéo a échoué.	El análisis de segmentación del vídeo falló.
error_video_segmentation_annotation_failed	Video segmentation analysis failed.	L'analyse de segmentation vidéo a échoué.	El análisis de segmentación del vídeo falló.
error_process_interrupted	Video analysis interrupted due to unknown cause. Please re-submit the video.	L'analyse de la vidéo a été interrompue dû à une cause inconnue. Veuillez ré-envoyer la vidéo.	El análisis del video se ha interrumpido por una causa inconocida. Inténtalo con otro video. 
error_analysis_stopped_corrupted_video_file	Video analysis quitted due to corrupted video file.	L'analyse de la vidéo s'est arrêté dû à des fichiers vidéos corrompus.	El análisis del video se ha interrumpido debido a archivos videos corruptos. 
error_analysis_stopped_unsupported_file_extension	Video analysis quitted due to unsupported file extension.	L'analyse de la vidéo s'est arrêté dû à un format vidéo non supporté.	El análisis del video se ha interrumpido debido a un formato video incompatible.
error_conflict	The video is already being processed by this user.	La vidéo est déjà en analyse par cet utilisateur.	Ya se está analizando este video por este usuario.
wait_video_waiting_in_queue	Video in queue for analysis. The analysis of your video will start immediately after all preceding videos in the queue have been processed.	Vidéo en file d'attente pour analyse. L'analyse de votre vidéo commencera immédiatement après que toutes les vidéos précédentes de la file d'attente auront été traitées.	Análisis del video en espera. El análisis del video empezará inmediatamente después de que todos los videos en espera hayan sido tratados.
wait_video_download_started	The video is being downloaded before its analysis.	La vidéo est en train d'être téléchargé avant analyse.	Se guarda el video en caché antes de analizarla
wait_started	Video analysis running. Step	Analyse de la vidéo en cours. Etape 	Análisis de vídeo en marcha. Paso
metadata_title	Video Metadata	Métadonnées de la video	Metadatos del video
metadata_name_1	Moov	Moov	Moov
metadata_name_2	Duration	Durée	Duración
metadata_name_3	Timescale	Unité de temps	Escala temporal
metadata_name_4	Duration of fragment	Durée d'un fragment	Duración del fragmento
metadata_name_5	Fragmented	Fragmenté	Fragmentado
metadata_name_6	Progressive	Progressive	Progresiva
metadata_name_7	IOD	IOD	IOD
metadata_name_8	Brands	Type	Marcas
metadata_name_9	Created time	Date de création	Fecha de creación
metadata_name_10	Modified time	Date de modification	Fecha de modificación
metadata_desc_1			
metadata_desc_2	Number providing the duration of the movie (unfragmented part) in timescale units	Nombre donnant la durée du film (partie défragmentée) en unité de temps	Número que indica la duración del video (parte no fragmentada) en unidades de tiempo.
metadata_desc_3	Number corresponding to the timescale as given in the movie header	Nombre correspondant è l'unité de temps donnée dans l'entête du film	Número correspondiente a la escala de tiempo tal y como aparece en el encabezamiento del video
metadata_desc_4	Boolean indicating if the file is already fragmented	Booléen indiquant si le film est déjà fragmenté	Booleano que indica si el archivo ya está fragmentado
metadata_desc_5	Number giving the duration of the fragmented part of the file in timescale units	Number donnant la durée de la partie fragmentée du film en unité de temps	Número que indica la duración de la parte fragmentada del video en unidades de tiempo
metadata_desc_6	Boolean indicating if the file can be played progressively	Booléen indiquant si le fichier peut être lu progressivement	Booleano que indica si el archivo puede ser leido progresivamente
metadata_desc_7	Boolean indicating if the the file contains an MPEG-4 Initial Object Descriptor	Booléen indiquant si le fichier contient un MPEG-4 Initial Object Descriptor	Booleano que indica si el archivo contiene un descriptor de objeto MPEG-4
metadata_desc_8	Array of 4CC codes corresponding to the file brands as given in the ftyp box	Tableau de code 4CC correspondant au type de fichier comme donné dans la boite ftyp	Matriz de códigos 4CC correspondientes a las marcas de archivo tal y como aparecen en la casilla ftyp
metadata_desc_9	Date object indicating the creation date of the file as given in the movie header	Date indiquant la date de création du fichier comme donné dans l'entête du film	Fecha que indica la fecha de creación del archivo tal y como aparece en la cabecera de la película.
metadata_desc_10	Date object indicating the last modification date of the file as given in the movie header	Date indiquant la date de dernière modification du fichier comme donnée dans l'entête du film	Fecha que indica la fecha de última modificación del archivo como dato en la cabecera del video
track_title	Video Track	Piste vidéo	Pista de video
track_name_1	Identifier	Identifiant	Identificador
track_name_2	References	Réferences	Referencias
track_name_3	Created time	Date de création	Fecha de creación
track_name_4	Modified time	Date de modification	Fecha de modificación
track_name_5	Movie duration	Durée du film	Duración del video
track_name_6	Layer	Couches	Capas
track_name_7	Alternate group	Groupes alternatifs	Grupo alternativo
track_name_8	Volume	Volume	Volumen
track_name_9	Width	Largeur	Largo
track_name_10	Height	Hauteur	Altura
track_name_11	Timescale	Unité de temps	Escala de tiempo
track_name_12	Duration	Durée	Duración
track_name_13	Codec	Codec	códec
track_name_14	Language	Langage	Idioma
track_name_15	Samples	Echantillon	Muestras
track_name_16	Size	Taille	Tamaño
track_name_17	Bitrate	Taux de bit	Tasa de bits
track_desc_1	Number; giving track identifier	Nombre; Identifiant de la piste	Número; identificador de la pista
track_desc_2			
track_desc_3	Date object; indicating the creation date of the file as given in the track header	Date; indiquant la date de création du fichier comme donnée dans l'entête de la piste	Fecha; indicando la fecha de creación del fichero tal y como aparece en la cabecera de la pista
track_desc_4	Date object; indicating the last modification date of the file as given in the track header	Date; indiquant la date de dernière modification du fichier comme donnée dans l'entête de la piste	Fecha; indicando la fecha de última modificación del fichero tal y como aparece en la cabecera de la pista
track_desc_5			
track_desc_6	Number; layer information as indicated in the track header	Nombre; information de couche indiqué dans l'entête de piste	Número; información de capa como se indica en el encabezado de la pista
track_desc_7	Number; identifier of the alternate group the track belongs to	Nombre; identifiant du groupe alternatif auquel la piste appartient	Número; identificador del grupo alternativo del cual pertenece la pista
track_desc_8			
track_desc_9	Number; width of the track as indicated in the track header	Nombre; largeur de la piste comme indiqué dans l'entête de piste	Número; anchura de la pista como indicado en el encabezamiento de la pista
track_desc_10	Number; height of the track as indicated in the track header	Nombre; hauteur de la piste comme indiqué dans l'entête de piste	Número; altura de la pista como indicado en el encabezamiento de la pista
track_desc_11	Number; indicating the track timescale as given in the track header	Nombre; indiquant l'unité de temps de la piste comme donné dans l'entête de la piste	Número; indicando la unidad de tiempo de la pista como indicado en el encabezamiento de la pista
track_desc_12	Number; providing the duration of the (unfragmented part of) track in timescale units	Nombre; donnant la duréee de la (partie défragmentée de la) piste en unité de temps	Número; indicando la duración de la (parte desfragmentada de la) pista en unidad de tiempo
track_desc_13	String; giving the MIME codecs parameter for this track (e.g. ''avc1.42c00d'' or ''mp4a.40.2'') to be used to create SourceBuffer objects with Media Source Extensions	Chaîne de charactère; donnant les paramètres codecs MIME pour cette piste (ex. ''avc1.42c00d'' ou ''mp4a.40.2'') pour être utilisé pour créer un objet SourceBuffer avec Media Source Extensions	Cadena de carácter; indicando los parametros codecs MIME para esta pista (ej. "avc1.42c00d" o "mp4a.40.2') para utilizarla para crear un objeto SourceBuffer con Media Source Extensions
track_desc_14	String; giving the 3-letter language code	Chaîne de charactère; donnant le code de langage à 3 lettres	Cadena de carácter; indicando el código de idioma con 3 letras
track_desc_15	Number; giving the number of track samples (ie. frames)	Nombre; donnant le nombre d'échantillons de piste (c-à-d images)	Número; indicando el número de muestras de pista (es decir imágenes)
track_desc_16			
track_desc_17	Number; providing the bitrate of the track in bits per second	Nombre; taux de bits par second de la piste	Número; tasa de bits por segundo de la pista
audio_title	Audio track	Piste audio	Pista audio
audio_name_1	Identifier	Identifiant	Identificador
audio_name_2	References	Réferences	Referencias
audio_name_3	Created time	Date de création	Fecha de creación
audio_name_4	Modified time	Date de modification	Fecha de modificación
audio_name_5	Movie duration	Durée du film	Duración del video
audio_name_6	Layer	Couches	Capa
audio_name_7	Alternate group	Groupes alternatifs	Grupo alternativo
audio_name_8	Volume	Volume	Volumen
audio_name_9	Width	Largeur	Anchura
audio_name_10	Height	Hauteur	Altura
audio_name_11	Timescale	Unité de temps	Unidad de tiempo
audio_name_12	Duration	Durée	Duración
audio_name_13	Codec	Codec	Códec
audio_name_14	Language	Langage	Idioma
audio_name_15	Samples	Echantillon	Muestras
audio_name_16	Size	Taille	Tamaño
audio_name_17	Bitrate	Taux de bit	Tasa de bits
audio_desc_1	Number; giving track identifier	Nombre; Identifiant de la piste	Número; identificador de pista
audio_desc_2			
audio_desc_3	Date object; indicating the creation date of the file as given in the track header	Date; indiquant la date de création du fichier comme donnée dans l'entête de la piste	Fecha; indicando la fecha de creación del fichero como indicado en el encabezamiento de la pista
audio_desc_4	Date object; indicating the last modification date of the file as given in the track header	Date; indiquant la date de dernière modification du fichier comme donnée dans l'entête de la piste	Fecha; indicando la fecha de la ultima modificación del fichero como indicado en el encabezamiento de la pista
audio_desc_5			
audio_desc_6	Number; layer information as indicated in the track header	Nombre; information de couche indiqué dans l'entête de piste	Número; información de la capa indicada en el encabezamiento de la pista
audio_desc_7	Number; identifier of the alternate group the track belongs to	Nombre; identifiant du groupe alternatif auquel la piste appartient	Número; identificación del grupo alternativo del cual pertenece la pista
audio_desc_8			
audio_desc_9	Number; width of the track as indicated in the track header	Nombre; largeur de la piste comme indiqué dans l'entête de piste	Número; anchura de la pista como indicado en el encabezamiento de la pista
audio_desc_10	Number; height of the track as indicated in the track header	Nombre; hauteur de la piste comme indiqué dans l'entête de piste	Número; altura de la pista como indicado en el encabezamiento de la pista 
audio_desc_11	Number; indicating the track timescale as given in the track header	Nombre; indiquant l'unité de temps de la piste comme donné dans l'entête de la piste	Número; indicando la unidad de tiempo de la pista como indicado en el encabezamiento de la pista 
audio_desc_12	Number; providing the duration of the (unfragmented part of) track in timescale units	Nombre; donnant la duréee de la (partie défragmentée de la) piste en unité de temps	Número; indicando la duración de la (parte desfragmentada de la) pista en unidad de tiempo
audio_desc_13	String; giving the MIME codecs parameter for this track (e.g. ''avc1.42c00d'' or ''mp4a.40.2'') to be used to create SourceBuffer objects with Media Source Extensions	Chaîne de charactère; donnant les paramètres codecs MIME pour cette piste (ex. ''avc1.42c00d'' ou ''mp4a.40.2'') pour être utilisé pour créer un objet SourceBuffer avec Media Source Extensions	Cadena de carácter; indicando los parametros codecs MIME para esta pista (ej. "avc1.42c00d" o "mp4a.40.2') para utilizarla para crear un objeto SourceBuffer con Media Source Extensions
audio_desc_14	String; giving the 3-letter language code	Chaîne de charactère; donnant le code de langage à 3 lettres	Cadena de carácter; indicando el código de idioma con 3 letras
audio_desc_15	Number; giving the number of track samples (ie. frames)	Nombre; donnant le nombre d'échantillons de piste (c-à-d images)	Número; indicando el número de muestras de pista (es decir imágenes)
audio_desc_16			
audio_desc_17	Number; providing the bitrate of the track in bits per second	Nombre; taux de bits par second de la piste	Número; tasa de bits por segundo de la pista 
metadata_content_title	Metadata	Métadonnées	Metadatos
metadata_content_input	Image URL in jpg/jpeg or video URL in mp4/m4v format	Adresse de l'image au format jpg/jpeg ou video au format mp4/m4v	Enlace del imagen en formato jpg/jpeg o video en formato mp4/m4v
metadata_radio_image	Image	Image	Imagen
metadata_radio_video	Video	Vidéo	Video
metadata_table_error	Video failed loading. Check the URL and try again	Vidéo impossible à charger. Veuillez verifier l'URL et réessayer	Fue imposible descargar el video. Verifica el URL y vuelve a intentarlo
metadata_img_software_title	Software infos	Informations logicielles	Informaciones del software
metadata_img_software_fields_1	Make	Marque	Marca
metadata_img_software_fields_2	Model	Modèle	Modelo
metadata_img_software_fields_3	Orientation	Orientation	Orientación 
metadata_img_software_fields_4	X Resolution	Résolution X	Resolución X
metadata_img_software_fields_5	Y Resolution	Résolution Y	Resolución Y 
metadata_img_software_fields_6	Resolution Unit	Unité de résolution	Unidad de resolución
metadata_img_software_fields_7	Host Computer	Ordinateur hôte	Ordenador host
metadata_img_software_fields_8	Software	Logiciel	Software
metadata_img_software_fields_9	Modify Date	Date modification	Fecha de modificación
metadata_img_software_fields_10	YCbCr Positioning	Positionnement YCbCr	Posicionamiento YCbCr
metadata_img_software_fields_11	Copyright	Droits d'auteurs	Derechos de autor
metadata_img_software_desc_1			
metadata_img_software_desc_2			
metadata_img_software_desc_3			
metadata_img_software_desc_4			
metadata_img_software_desc_5			
metadata_img_software_desc_6			
metadata_img_software_desc_7	The computer and/or operating system in use at the time of image creation	L'ordinateur et/ou système opérateur utilisé au moment où la photo à été créée	El ordenador y/o el sistema operador utilizado en el momento en el que se crea la foto
metadata_img_software_desc_8			
metadata_img_software_desc_9	Timestamp for when you might alter the image or it's metadata	Horodatage de la possibilité de modification de l'image ou de ses métadonnées	Cronomarcador de la posibilidad de modificación de la imagen o de sus metadatos
metadata_img_software_desc_10	Specifies the positioning of subsampled chrominance components relative to luminance samples. Field value 1 (centered) must be specified for compatibility with industry standards such as PostScript Level 2 and QuickTime. Field value 2 (cosited) must be specified for compatibility with most digital video standards, such as CCIR Recommendation 601-1	Spécifie le positionnement des composants de chrominance sous-échantillonnés par rapport aux échantillons de luminance. La valeur de champ 1 (center) doit être spécifiée pour la compatibilité avec les normes de l'industrie telles que PostScript Level 2 et QuickTime. La valeur de champ 2 (cosited) doit être spécifiée pour la compatibilité avec la plupart des normes vidéo numériques, telles que la Recommandation 601-1 du CCIR	Especifica el posicionamiento de los componentes de crominancia submuestreados en relación con las muestras de luminancia. El valor del campo 1 (centrado) debe especificarse para que sea compatible con los estándares del sector, como PostScript Level 2 y QuickTime. El valor del campo 2 (cosited) debe especificarse para que sea compatible con la mayoría de las normas de vídeo digital, como la Recomendación 601-1 del CCIR.
metadata_img_software_desc_11			
metadata_img_general_title	General EXIF infos	Informations EXIF	Informaciones EXIF
metadata_img_general_fields_1	Artist	Artiste	Artista
metadata_img_general_fields_2	Document Name	Nom du document	Nombre del documento
metadata_img_general_fields_3	Page Name	Nom de la page	Nombre de la página
metadata_img_general_fields_4	Exposure Time	Temps d'exposition	Tiempo de exposición
metadata_img_general_fields_5	F-Number	Nombre F	Número F
metadata_img_general_fields_6	Exposure Program	Programme d'exposition	Programa de exposición 
metadata_img_general_fields_7	EXIF Version	Version EXIF	Versión EXIF
metadata_img_general_fields_8	Date Time Original	Horodatage d'origine	Cronomarcador de origen 
metadata_img_general_fields_9	Date Time Digitized	Horodatage numérisée	Cronomarcador numerizado 
metadata_img_general_fields_10	Components Configuration	Configuration des composants	Configuración de los componentes 
metadata_img_general_fields_11	Compressed Bits Per Pixel	Bits compressés par pixel	Bits comprimidos por pixel 
metadata_img_general_fields_12	Exposure Bias	Biais d'exposition	Sesgo de exposición
metadata_img_general_fields_13	Max Aperture Value	Valeur d'ouverture maximale	Valor de apertura maxima
metadata_img_general_fields_14	Metering Mode	Mode de mesure	Modo de medida
metadata_img_general_fields_15	Flash	Flash	Flash
metadata_img_general_fields_16	Focal Length	Longueur focale	Distancia focal
metadata_img_general_fields_17	User Comment	Commentaire utilisateur	Comentario usuario 
metadata_img_general_fields_18	Image Description	Description de l'image	Descripción de la imagen 
metadata_img_general_fields_19	Maker Note	Note du fabricant	Nota del fabricante 
metadata_img_general_fields_20	Subject Distance	Distance du sujet	Distancia del sujeto 
metadata_img_general_fields_21	Flashpix Version	Version Flashpix	Versión Flashpix 
metadata_img_general_fields_22	Color Space	Espace colorimétrique	Espacio ...
metadata_img_general_fields_23	X Dimension	Dimension X	Dimensión X
metadata_img_general_fields_24	Y Dimension	Dimension Y	Dimensión Y
metadata_img_general_fields_25	File Source	Source du fichier	Fuente del fichero
metadata_img_general_desc_1	Person who created the image	Personne qui a créé l'image	Persona que ha creado la imagen
metadata_img_general_desc_2			
metadata_img_general_desc_3			
metadata_img_general_desc_4	The length of time when the film or digital sensor inside the camera is exposed to light	La durée pendant laquelle le film ou le capteur numérique à l'intérieur de l'appareil photo est exposé à la lumière	La duración durante la cual se expone al sol la película o el captor numérico al interior de la cámara 
metadata_img_general_desc_5	The ratio of the system's focal length to the diameter of the entrance pupil	Le rapport entre la distance focale du système et le diamètre de la pupille d'entrée	La diferencia entre la distancia focal del sistema y el diámetro de la pupila de entrada 
metadata_img_general_desc_6	The program used by the camera to set exposure when the picture is taken	Le programme utilisé par l'appareil photo pour définir l'exposition lorsque la photo est prise	El programa utilizado por la cámara para definir la exposición cuando se toma la foto
metadata_img_general_desc_7			
metadata_img_general_desc_8	The date and time when the original image data was generated	La date et l'heure auxquelles les données de l'image d'origine ont été générées	La fecha y la hora en las cuales los datos de la imagen de origen han sido generadas
metadata_img_general_desc_9	The date and time when the image was stored as digital data	La date et l'heure à laquelle l'image a été stockée sous forme de données numériques	La fecha y la hora en la cual la imagen ha sido archivada bajo datos numéricos
metadata_img_general_desc_10	Provided for cases when compressed data uses components other than Y, Cb, and Cr and to enable support of other sequences	Fourni pour les cas où des données compressées utilisent des composants autres que Y, Cb et Cr et pour permettre la prise en charge d'autres séquences	Proporcionado para casos en los que los datos comprimidos utilizan componentes distintos de Y, Cb y Cr y para permitir el soporte de otras secuencias.
metadata_img_general_desc_11			
metadata_img_general_desc_12	Adjustment to either underexpose or overexpose the image	Réglage pour sous-exposer ou surexposer l'image	Ajuste para subexponer o sobreexponer la imagen
metadata_img_general_desc_13	The smallest F number of the lens	Le plus petit nombre F de l'objectif	El número F más pequeño de la lente
metadata_img_general_desc_14			
metadata_img_general_desc_15			
metadata_img_general_desc_16	The actual focal length of the lens, in mm	La distance focale réelle de l'objectif, en mm	La distancia focal real de la lente, en mm
metadata_img_general_desc_17	Keywords or comments on the image	Mots-clés ou commentaires sur l'image	Palabras clave o comentarios sobre la imagen
metadata_img_general_desc_18	A string that describes the subject of the image	Un texte décrivant le sujet de l'image	Una cadena que describe el objeto de la imagen
metadata_img_general_desc_19	Manufacturer specific information	Note du fabricant	Información específica del fabricante
metadata_img_general_desc_20	The distance to the subject, given in meters (0 if unknown and FFFFFFFF if infinite)	La distance jusqu'au sujet de la photo, en mètre (0 si inconnu et FFFFFFFF si infini)	La distancia al sujeto, dada en metros (0 si es desconocida y FFFFFFFFFF si es infinita).
metadata_img_general_desc_21			
metadata_img_general_desc_22	Normally sRGB (=1) is used to define the color space based on the PC monitor conditions and environment. If a color space other than sRGB is used, Uncalibrated (=65535) is set	Normalement, sRGB (= 1) est utilisé pour définir l’espace colorimétrique en fonction des conditions et de l’environnement du moniteur. Si un espace colorimétrique autre que sRGB est utilisé, le paramètre 'Uncalibrated' (= 65535) est défini	Normalmente se utiliza sRGB (=1) para definir el espacio de color basándose en las condiciones y el entorno del monitor de PC. Si se utiliza un espacio de color distinto de sRGB, se establece sin calibrar (=65535).
metadata_img_general_desc_23			
metadata_img_general_desc_24			
metadata_img_general_desc_25			
metadata_img_gps_title	GPS Informations	Informations GPS	Información GPS
metadata_img_gps_fields_1	GPS Latitude Ref.	Ref. Latitude GPS	Latitud GPS Ref.
metadata_img_gps_fields_2	GPS Latitude	Latitude GPS	Latitud GPS
metadata_img_gps_fields_3	GPS Longitude Ref.	Ref. Longitude GPS	Longitud GPS Ref.
metadata_img_gps_fields_4	GPS Longitude	Longitude GPS	Longitud GPS
metadata_img_gps_fields_5	GPS Time Stamp	Horodatage GPS	Marca de tiempo GPS
metadata_img_gps_desc_1			
metadata_img_gps_desc_2			
metadata_img_gps_desc_3			
metadata_img_gps_desc_4			
metadata_img_gps_desc_5			
metadata_gps_button	View GPS location	Afficher localisation GPS	Ver ubicación GPS
metadata_img_error	Image failed loading. Check the URL and try again	Image impossible à charger. Veuillez verifier l'URL et réessayer	Fallo en la carga de la imagen. Compruebe la URL e inténtelo de nuevo
metadata_img_key_Orientation_1	The 0th row represents the visual top of the image, and the 0th column represents the visual left-hand side	La ligne 0 représente le haut visuel de l’image et la colonne 0 représente le visuel de gauche	La fila 0 representa la parte superior visual de la imagen, y la columna 0 representa el lado izquierdo visual.
metadata_img_key_Orientation_2	The 0th row represents the visual top of the image, and the 0th column represents the visual right-hand side	La ligne 0 représente le sommet visuel de l’image et la colonne 0 représente le visuel de droite	La fila 0 representa la parte superior visual de la imagen, y la columna 0 representa el lado derecho visual.
metadata_img_key_Orientation_3	The 0th row represents the visual bottom of the image, and the 0th column represents the visual right-hand side	La ligne 0 représente le bas visuel de l'image et la colonne 0 représente le côté droit de l'image	La fila 0 representa la parte inferior visual de la imagen, y la columna 0 representa la parte derecha visual.
metadata_img_key_Orientation_4	The 0th row represents the visual bottom of the image, and the 0th column represents the visual left-hand side	La ligne 0 représente le bas visuel de l’image et la colonne 0 représente le visuel gauche de l'image	La fila 0 representa la parte inferior visual de la imagen, y la columna 0 representa el lado izquierdo visual.
metadata_img_key_Orientation_5	The 0th row represents the visual left-hand side of the image, and the 0th column represents the visual top	La ligne 0 représente le côté gauche visuel de l'image et la colonne 0 représente le sommet visuel	La fila 0 representa el lado izquierdo visual de la imagen, y la columna 0 representa la parte superior visual.
metadata_img_key_Orientation_6	The 0th row represents the visual right-hand side of the image, and the 0th column represents the visual top	La ligne 0 représente le côté droit visuel de l’image et la colonne 0 représente le sommet visuel	La fila 0 representa el lado derecho visual de la imagen, y la columna 0 representa la parte superior visual.
metadata_img_key_Orientation_7	The 0th row represents the visual right-hand side of the image, and the 0th column represents the visual bottom	La ligne 0 représente le côté droit visuel de l’image et la colonne 0 représente le bas visuel	La fila 0 representa el lado derecho visual de la imagen, y la columna 0 representa el fondo visual.
metadata_img_key_Orientation_8	The 0th row represents the visual left-hand side of the image, and the 0th column represents the visual bottom	La ligne 0 représente le côté gauche visuel de l'image et la colonne 0 représente le bas visuel	La fila 0 representa el lado izquierdo visual de la imagen, y la columna 0 representa el fondo visual.
metadata_img_key_ResolutionUnit_1	No absolute unit of measurement. Used for images that may have a non-square aspect ratio, but no meaningful absolute dimensions	Pas d'unité de mesure absolue. Utilisé pour les images qui peuvent avoir un rapport d'aspect non carré, mais pas de dimensions absolues significatives	No hay unidad de medida absoluta. Se utiliza para imágenes que pueden tener una relación de aspecto no cuadrada, pero sin dimensiones absolutas significativas.
metadata_img_key_ResolutionUnit_2	Measurement unit is inch	Unité de mesure en pouces	Unidad de medida en pulgadas
metadata_img_key_ResolutionUnit_3	Measurement unit is centimeter	Unité de mesure en centimètres	La unidad de medida es de un centímetro
metadata_img_error_exif	No EXIF Metadata was found. <strong>Note:</strong> The EXIF standard applies only to .jpg and .tiff images	Aucune métadonnée EXIF n'a été trouvée. <strong>Note:<strong> Le Format EXIF s'applique uniquement aux images .jpg et .tiff	No se encontraron metadatos EXIF. <strong>Note:</strong> El estándar EXIF se aplica sólo a imágenes.jpg y.tiff
api_error_removed_video	This video has been previously processed by the CAA service but it is no longer available on the video platform. All metadata associated with that video have been deleted.	Cette vidéo a été précédemment traitée par le service CAA mais elle n'est maintenant plus accessible via la plateforme vidéo. Toutes les meta données de cette vidéo ont été effacées.	Este vídeo ha sido procesado previamente por el servicio CAA pero ya no está disponible en la plataforma de vídeo. Se han eliminado todos los metadatos asociados a ese vídeo.
api_error_no_video	The metadata associated with this video could not be extracted. The video is either posted by Facebook User or Group; and due to Facebook API limitations it  cannot be processed or it might no longer be available on the video platform.	Les métadonnées associées à cette vidéo n'ont pas pu être extraites. La vidéo est publiée par l'utilisateur ou le groupe Facebook; et en raison des limitations de l'API Facebook elle ne peut pas être traitée ou peut ne plus être disponible sur la plateforme vidéo.	Los metadatos asociados a este vídeo no se pudieron extraer. El vídeo es publicado por un usuario o grupo de usuarios de Facebook y, debido a las limitaciones de la API de Facebook, no se puede procesar o puede que ya no esté disponible en la plataforma de vídeo.
api_error_no_video_id	A video ID cannot be extracted by the submitted URL. Please check the URL.	Un identifiant vidéo ne peut pas être extrait de l'URL donnée. Veuillez vérifier cette URL.	Un ID de vídeo no se puede extraer mediante la URL enviada. Por favor, compruebe la URL.
api_error_empty_url	The submitted URL parameter is empty. Please provide a valid video URL.	L'URL donnée en paramètre est vide. Veuillez utilisez une URL valide.	El parámetro URL enviado está vacío. Por favor, proporcione una URL de vídeo válida.
api_error_facebook_group	The provided Video is posted by a Facebook Group. Due to Facebook API restrictions no information can be retrieved for videos posted by Facebook Groups.	La vidéo fournie vient d'un Groupe Facebook. En raison des restrictions de l'API Facebook aucune information ne peut être récupérée pour les vidéos postées par les Groupes Facebook.	El vídeo proporcionado es publicado por un grupo de Facebook. Debido a las restricciones de la API de Facebook, no se puede recuperar información para los vídeos publicados por los grupos de Facebook.
api_error_facebook_photo	The provided URL is not supported. It is a photo URL.	L'URL fournie n'est pas prise en charge. C'est une URL de photo.	La URL proporcionada no es compatible. Es la URL de una foto.
api_error_default	There was an error while trying to process this video. Please check the link and try again	Une erreur est survenue lors du traitement des la vidéo. Veuillez verifier le lien et réessayer.	Se ha producido un error al intentar procesar este vídeo. Por favor, compruebe el enlace e inténtelo de nuevo
table_error_removed_video	This video has been previously processed by the CAA service but it is no longer available on the video platform. All metadata associated with that video have been deleted	Cette vidéo a été précédemment traitée par le service CAA mais elle n'est maintenant plus accessible via la plateforme vidéo. Toutes les meta données de cette vidéo ont été effacées	Este vídeo ha sido procesado previamente por el servicio CAA pero ya no está disponible en la plataforma de vídeo. Se han eliminado todos los metadatos asociados a ese vídeo.
table_error_no_video	The metadata associated with this video could not be extracted. The video is either posted by Facebook User or a Group, and due to Facebook API limitations it  cannot be processed, or it might no longer be available on Facebook	Les métadonnées associées à cette vidéo n'ont pas pu être extraites. La vidéo est publiée par l'utilisateur ou le groupe Facebook et, en raison des limitations de l'API Facebook, elle ne peut pas être traitée ou peut ne plus être disponible sur la plateforme vidéo	Los metadatos asociados a este vídeo no se pudieron extraer. El vídeo está publicado por un usuario de Facebook o un grupo y, debido a las limitaciones de la API de Facebook, no se puede procesar o puede que ya no esté disponible en Facebook.
table_error_no_video_id	A video ID cannot be extracted by the submitted URL. Please check the URL	Un identifiant vidéo ne peut pas être extrait de l'URL donnée. Veuillez vérifier cette URL	Un ID de vídeo no se puede extraer mediante la URL enviada. Por favor, compruebe la URL
table_error_empty_url	The submitted URL parameter is empty. Please provide a valid video URL	L'URL donnée en paramètre est vide. Veuillez utilisez une URL valide	El parámetro URL enviado está vacío. Por favor, proporcione una URL de vídeo válida
table_error_facebook_group	The provided Video is posted by a Facebook Group. Due to Facebook API restrictions no information can be retrieved for videos posted by Facebook Groups	La vidéo fournie vient d'un Groupe Facebook. En raison des restrictions de l'API Facebook, aucune information ne peut être récupérée pour les vidéos postées par les Groupes Facebook	El vídeo proporcionado es publicado por un grupo de Facebook. Debido a las restricciones de la API de Facebook, no se puede recuperar información para los vídeos publicados por los grupos de Facebook.
table_error_facebook_photo	The provided URL is not supported. It is a photo URL	L'URL fournie n'est pas prise en charge. C'est une URL de photo	La URL proporcionada no es compatible. Es una URL de la foto
table_error_default	There was an error while trying to process this video. Please check the link and try again	Une erreur est survenue lors du traitement des la vidéo. Veuillez verifier le lien et réessayer	Se ha producido un error al intentar procesar este vídeo. Por favor, compruebe el enlace e inténtelo de nuevo
keyframes_title	Video fragmentation and reverse image search	Fragmentation vidéo et recherche inversée d'image	Fragmentación del video y búsqueda inversa de imagen
keyframes_tip	With the contextual menu (right click) you can query multiple reverse image search engines or use the magnifier and forensic tools on each keyframe.	Avec le menu contextuel (clic droit) vous pouvez utiliser plusieurs moteurs de recherches d'images ou utiliser la loupe ou l'outil forensic sur chaque image clé.	Con el menú contextual (clic derecho), puede Ud. utilizar varios motores de busqueda inversa de imagen o utilizar la lupa o la herramienta de forensic sobre cada imagen clave
keyframes_input	Insert the video URL	Adresse de la vidéo	Enlace del video
keyframes_content_title	Video keyframes	Images clés de la vidéo	Imágenes claves del video
keyframes_content_acco	Show more keyframes	Afficher plus d'images clés	Mostrar más imágenes claves
keyframes_download	Download .zip files	Téléchargement des fichiers .zip	Descarga de ficheros zip
keyframes_download_thumb	ZIP of thumbnails	ZIP des images clés	Zip de imágenes claves
keyframes_download_shots	ZIP of shots	ZIP des images clés	Zip de imágenes claves
keyframes_download_subshots	ZIP of subshots	ZIP des images clés	Zip de imágenes claves
keyframes_error_VIDEO_DOWNLOAD_FAILED	Video download failed. Try with another video	Le téléchargement de la vidéo à échoué. Veuillez essayer avec une autre vidéo	La descarga de video falló. Inténtalo con otro vídeo
keyframes_error_VIDEO_DOWNLOAD_TIMEOUT	Video download failed. The video download has timed out	Le téléchargement de la vidéo à échoué. La vidéo a mis trop de temps à télécharger	La descarga de video falló. El tiempo de descarga del video se ha agotado.
keyframes_error_VIDEO_SEGMENTATION_FAILED	Video segmentation analysis failed	L'analyse de segmentation vidéo à échoué	Fallo en el análisis de segmentación de vídeo
keyframes_error_PROCESS_INTERRUPTED	Video analysis interrupted due to unknown cause. Please re-submit the video	L'analyse de la vidéo à été interrompue dû à une cause inconnue. Veuillez ré-envoyer la vidéo	El análisis de vídeo se interrumpió debido a una causa desconocida. Por favor, vuelva a enviar el vídeo
keyframes_error_ANALYSIS_STOPPED_CORRUPTED_VIDEO_FILE	Video analysis quitted due to corrupted video file	L'analyse de la vidéo s'est arrêté dû à des fichiers vidéos corrompus	El análisis de vídeo se ha interrumpido debido a que el archivo de vídeo está dañado.
keyframes_error_ANALYSIS_STOPPED_UNSUPPORTED_FILE_EXTENSION	Video analysis quitted due to unsupported file extension	L'analyse de la vidéo s'est arrêté dû à un format vidéo non supporté	El análisis de vídeo se ha interrumpido debido a que la extensión del archivo no es compatible.
keyframes_error_unavailable	The service is currently unavailable. Try again later	Le service est actuellement indisponible. Veuillez réessayez plus tard	El servicio no está disponible en este momento. Inténtalo de nuevo más tarde
keyframes_error_default	Unknown error occured. Please try again later or with another video	Une erreur inconnue s'est produite. Veuillez réessayer plus tard ou avec une autre vidéo	Se ha producido un error desconocido. Por favor, inténtelo de nuevo más tarde o con otro vídeo
keyframes_wait_VIDEO_WAITING_IN_QUEUE	Video in queue for analysis. The analysis of your video will start immediately after all preceding videos in the queue have been processed	Vidéo en file d'attente pour analyse. L'analyse de votre vidéo commencera immédiatement après que toutes les vidéos précédentes de la file d'attente auront été traitées	Vídeo en cola para análisis. El análisis de su vídeo se iniciará inmediatamente después de que se hayan procesado todos los vídeos anteriores de la cola.
keyframes_wait_VIDEO_DOWNLOAD_STARTED	The video is being downloaded before its analysis	La vidéo est en train d'être téléchargé avant analyse	El video está siendo descargado antes de su análisis
keyframes_wait_STARTED	Video analysis running. Step 	Analyse de la vidéo en cours. Etape 	Análisis de vídeo en marcha. Paso
youtube_title	Youtube thumbnails reverse search	Recherche inversée des imagettes Youtube	
youtube_input	Youtube video URL	Adresse de la vidéo Youtube	
twitter_title	Twitter advanced search	Recherche avancée Twitter	
twitter_termbox	Keyword or #	Mot clé ou #	Palabra clave o #
twitter_tw-account	From (Twitter account name)	De (Nom de compte Twitter)	De (Nombre de una cuenta de Twitter)
twitter_filter	Filter (e.g. safe, media, retweets, native_video, periscope, vine, images, twimg or links)	Filtre (ex. safe, media, retweets, native_video, periscope, vine, images, twimg or links)	Filtro (ej. safe, media, retweets, native_video, periscope, vine, images, twimg or links)
twitter_lang	Language (e.g. en, fr, de, es, ru, ja, zh...)	Langue (ex: en, fr, de, es ru, ja, zh...)	Idioma (ej: en, fr, de, es ru, ja, zh...)
twitter_geocode	Geocode (e.g. -22.912214,-43.230182,1km or -22.912214,-43.230182,1mi)	Geocode (ex: -22.912214,-43.230182,1km ou -22.912214,-43.230182,1mi)	Geocodigo (ej: -22.912214,-43.230182,1km ou -22.912214,-43.230182,1mi)
twitter_near	Near (city name)	Proche de : (nom de ville)	Cerca de (nombre de ciudad)
twitter_within	Within (e.g. 15mi or 15km)	Dans (ex: 15mi ou 15km)	Dentro de (ej: 15mi o 15 km)
twitter_from-date	Since	Depuis	Desde
twitter_to-date	Until	Jusqu'à	Hasta
twitter_local_time	Local time	Heure locale	Hora local
twitter_gmt	GMT	GMT	GMT
magnifier_title	Image Magnifier	Inspecteur d'image	Amplificador de imagen
magnifier_urlbox	Image URL	Adresse de l'image	"
magnifier_accor	More filters	Plus de filtres	Más filtros
magnifier_radio_1	None	Aucun	Ninguno
magnifier_radio_2	Sharp	Contraste	Contraste
magnifier_radio_3	Flip	Miroir	Voltear
magnifier_radio_4	Bicubic	Bicubic	Bicubic
magnifier_radio_5	Crop	Rogner	Recortar
magnifier_scale	Scale	Taille	Dimensión
magnifier_switch	Lens zoom / Inner zoom	Loupe / Zoom	Lupa / zoom
magnifier_google	Google Image	Google Image	Google imágenes
magnifier_baidu	Baidu Image	Baidu Image	Baidu imágenes
magnifier_yandex	Yandex Image	Yandex Image	Yandex imágenes
magnifier_tineye	Tineye Image	Tineye Image	Tineye imágenes
magnifier_forensic	Forensic	Forensic	Forensic
copyright_title	Check Video Copyright Status	Vérifier le copyright de la vidéo	Verificar los derechos de autor del video
copyright_input	Paste a YouTube, Twitter of Facebook video URL	Copier l'url de la video YouTube, Twitter ou Facebook	Copiar el enlace de la video de YouTube, Twitter o Facebook
forensic_title	Image forensic analysis	Analyse forensic d'image	Análisis forensic de imagen
forensic_input	Insert the image URL	Insérez l'URL d'une image	Insertar el enlace de la URL
forensic_content_title	Forensic analysis	Analyse forensic	Análisis forensic
forensic_error_unsupported_file	The submitted URL is an unsupported image file, e.g. gif image or video	L'URL soumise est un fichier image non pris en charge, par exemple une image gif ou une vidéo	La URL enviada es un archivo de imagen no compatible, por ejemplo, una imagen gif o un vídeo.
forensic_error_image_url_error	The submitted URL is an image file but it could not be downloaded, it may be due to network problem or download restrictions	L'URL soumise est un fichier image, mais il n'a pas pu être téléchargé. Cela peut être dû à un problème de réseau ou à des restrictions de téléchargement	La URL enviada es un archivo de imagen pero no se ha podido descargar, puede deberse a un problema de red o a restricciones de descarga.
forensic_error_url_error	The submitted URL could not be downloaded, it may be due to network problem, download restrictions or corrupted URL path	L'URL soumise n'a pas pu être téléchargée, cela peut être dû à un problème de réseau, aux restrictions de téléchargement ou a un chemin corrompu de l'URL	La URL enviada no se ha podido descargar, puede deberse a un problema de red, a restricciones de descarga o a una ruta de URL dañada.
forensic_error_hash_not_found	An unknown issue occured. Please check the URL and try again	Un problème inconnu s'est produit. Veuillez vérifier l'URL et réessayer	Se produjo un problema desconocido. Por favor, compruebe la URL e inténtelo de nuevo
forensic_error_empty_parameter	An unknown issue occured. Please check the URL and try again	Un problème inconnu s'est produit. Veuillez vérifier l'URL et réessayer	Se produjo un problema desconocido. Por favor, compruebe la URL e inténtelo de nuevo
forensic_error_missing_image_report	The image was not submitted. Please check the URL and try again	L'image n'a pas été soumise. Veuillez vérifier l'URL et réessayer	La imagen no fue enviada. Por favor, compruebe la URL e inténtelo de nuevo
forensic_error_analysis_not_triggered	The analysis has not been triggered for this image. Please check the URL and try again	L'analyse n'a pas été déclenchée pour cette image. Veuillez vérifier l'URL et réessayer	El análisis no se ha activado para esta imagen. Por favor, compruebe la URL e inténtelo de nuevo
forensic_title_dqReport	DQ	DQ	DQ
forensic_title_elaReport	ELA	ELA	ELA
forensic_title_medianNoiseReport	MEDIAN NOISE	MEDIAN NOISE	Ruido mediano
forensic_title_dctReport	DCT	DCT	DCT
forensic_title_gridsReport	CAGI	CAGI	CAGI
forensic_title_gridsInversedReport	CAGI-Inversed	CAGI-Inversé	CAGI-Invertido
forensic_title_dwNoiseReport	WAVELET	WAVELET	WAVELET
forensic_title_blockingReport	BLOCK	BLOCK	BLOCK
forensic_title_ghostReport	GHOST	GHOST	GHOST
forensic_card_info	Infos	Infos	
forensic_card_back	Back	Retour	Volver
forensic_card_dqReport	Double Quantization analysis detects the traces left by consecutive JPEG compressions on an image. When a spliced region from one image is inserted into another, if the compression histories of the two images differ, the discrepancy may be detected by this algorithm. A typical case of forgery that is detectable by this algorithm is when an item is taken from an image of high quality (or an uncompressed image, or an image that had its past JPEG traces destroyed by scaling/filtering) and placed in an image of lower quality. If the resulting spliced image is then saved as at a high quality, this should result in a successful detection. In the output map, red values (=1) correspond to high probability of a single compression for the corresponding block, while low values (=0) correspond to low probability of single compression. Localized red areas in an otherwise blue image are very likely to contain splices. Images with non-localized high values and values in the range (0.2-0.8) (green/yellow/orange) should not be taken into account.	L'analyse Double Quantification détecte les traces laissées par des compressions JPEG consécutives sur une image. Lorsqu'une région épissée d'une image est insérée dans une autre, si les historiques de compression des deux images diffèrent, la divergence peut être détectée par cet algorithme. Un exemple typique de falsification détectable par cet algorithme est lorsqu'un élément est extrait d'une image de haute qualité (ou d'une image non compressée, ou d'une image dont les traces JPEG antérieures ont été détruites par la mise à l'échelle / le filtrage) et placées dans une image de basse qualité. Si l'image épissée résultante est ensuite enregistrée avec une qualité élevée, cela devrait permettre une détection réussie. Dans la carte en sortie, les valeurs en rouge (= 1) correspondent à une probabilité élevée de compression simple pour le bloc correspondant, tandis que les valeurs faibles (= 0) correspondent à une probabilité faible de compression simple. Les zones rouges localisées dans une image autrement bleue sont très susceptibles de contenir des épissures. Les images avec des valeurs hautes non localisées et des valeurs comprises entre 0,2 et 0,8 (vert / jaune / orange) ne doivent pas être prises en compte.	El análisis de cuantización doble detecta las huellas que dejan las compresiones JPEG consecutivas en una imagen. Cuando se inserta una región empalmada de una imagen en otra, si las historias de compresión de las dos imágenes difieren, la discrepancia puede ser detectada por este algoritmo. Un caso típico de falsificación detectable por este algoritmo es cuando un objeto se toma de una imagen de alta calidad (o de una imagen sin comprimir, o de una imagen cuyas trazas JPEG pasadas fueron destruidas por escalado/filtrado) y se coloca en una imagen de menor calidad. Si la imagen de empalme resultante se guarda como de alta calidad, esto debería resultar en una detección exitosa. En el mapa de salida, los valores rojos (=1) corresponden a la alta probabilidad de una sola compresión para el bloque correspondiente, mientras que los valores bajos (=0) corresponden a la baja probabilidad de una sola compresión. Es muy probable que las áreas rojas localizadas en una imagen que de otra forma sería azul contengan empalmes. Las imágenes con valores altos no localizados y valores en el rango (0.2-0.8) (verde/amarillo/naranja) no deben ser tomadas en cuenta.
forensic_card_elaReport	Error Level Analysis is based on a technique very similar to JPEG Ghosts, that is the subtraction of a recompressed JPEG version of the suspect image from the image itself. In contrast to JPEG Ghosts, only a single version of the image is subtracted -in our case, of quality 75. Furthermore, while the output of JPEG Ghosts is normalized and filtered to enhance local effects, ELA output is returned to the user as-is. The assumption is that, when subtracting a recompressed version of the image from itself, regions that have undergone fewer (or less disruptive, higher-quality) compressions will yield a higher residual. When interpreted by an analyst, areas of interest are those that return higher values than other similar parts of the image. It is important to remember that only similar regions should be compared, i.e. edges should be compared to edges, and uniform regions should be compared to uniform regions.	Error Level Analysis est basé sur une technique très similaire à JPEG Ghosts, à savoir la soustraction d'une version JPEG recompressée de l'image suspecte à l'image elle-même. Contrairement aux JPEG Ghosts, une seule version de l’image est soustraite - dans notre cas, de qualité 75. En outre, bien que la sortie de JPEG Ghosts soit normalisée et filtrée pour améliorer les effets locaux, la sortie ELA est renvoyée à l’utilisateur - est. L’hypothèse est la suivante: lorsqu’on soustrait une version recompressée de l’image, les régions ayant subi moins de compressions (ou moins de perturbations et de meilleure qualité) produiront un résidu plus élevé. Lorsqu'ils sont interprétés par un analyste, les domaines d'intérêt sont ceux qui renvoient des valeurs plus élevées que d'autres parties similaires de l'image. Il est important de se rappeler que seules les régions similaires doivent être comparées, c'est-à-dire que les bords doivent être comparés aux bords et que les régions uniformes doivent être comparées aux régions uniformes.	El análisis de nivel de error se basa en una técnica muy similar a la de los fantasmas JPEG, es decir, la sustracción de una versión JPEG recomprimida de la imagen sospechosa de la propia imagen. A diferencia de JPEG Ghosts, sólo se resta una versión de la imagen -en nuestro caso, de calidad 75-. Además, mientras que la salida de JPEG Ghosts se normaliza y se filtra para mejorar los efectos locales, la salida de ELA se devuelve al usuario tal como está. La suposición es que, al restar una versión recomprimida de la imagen de sí misma, las regiones que han sufrido menos compresiones (o menos perturbadoras, de mayor calidad) producirán un residuo mayor. Cuando son interpretadas por un analista, las áreas de interés son aquellas que devuelven valores más altos que otras partes similares de la imagen. Es importante recordar que sólo deben compararse regiones similares, es decir, los bordes deben compararse con los bordes, y las regiones uniformes deben compararse con las regiones uniformes.
forensic_card_medianNoiseReport	Median Noise Residuals operate based on the observation that different images feature different high-frequency noise patterns. To isolate noise, we apply median filtering on the image and then subtract the filtered result from the original image. As the median-filtered image contains the low-frequency content of the image, the residue will contain the high-frequency content. The output maps should be interpreted by a rationale similar to Error Level Analysis, i.e. if regions of similar content feature different intensity residue, it is likely that the region originates from a different image source. As noise is generally an unreliable estimator of tampering, this algorithm should best be used to confirm the output of other descriptors, rather than as an independent detector.	Les résidus de bruit médian fonctionnent sur la base de l'observation que différentes images présentent différents modèles de bruit haute fréquence. Pour isoler le bruit, nous appliquons un filtrage médian à l'image, puis soustrayons le résultat filtré de l'image d'origine. Comme l'image filtrée par la médiane contient le contenu basse fréquence de l'image, le résidu contiendra le contenu haute fréquence. Les cartes en sortie doivent être interprétées selon une logique similaire à celle de l’analyse du niveau d’erreur, c’est-à-dire que si des régions de contenu similaire présentent des résidus d’intensité différente, il est probable que la région provienne d’une source d’image différente. Le bruit étant généralement un estimateur non fiable des altérations, cet algorithme devrait au mieux être utilisé pour confirmer le résultat des autres descripteurs, plutôt que comme détecteur indépendant.	Los residuos de ruido mediano operan basándose en la observación de que diferentes imágenes presentan diferentes patrones de ruido de alta frecuencia. Para aislar el ruido, aplicamos un filtro de mediana a la imagen y luego restamos el resultado filtrado de la imagen original. Como la imagen filtrada por el medio contiene el contenido de baja frecuencia de la imagen, el residuo contendrá el contenido de alta frecuencia. Los mapas de salida deben interpretarse con una lógica similar a la del análisis de nivel de error, es decir, si regiones de contenido similar presentan residuos de intensidad diferente, es probable que la región provenga de una fuente de imagen diferente. Como el ruido es generalmente un estimador de manipulación poco fiable, este algoritmo debería utilizarse mejor para confirmar la salida de otros descriptores, que como un detector independiente.
forensic_card_dctReport			
forensic_card_gridsReport	JPEG Blocking artifacts appear as a regular pattern of visible block boundaries in a JPEG compressed image, as a result of the quantization of the coefficients and the independent processing of the non-overlapping 8x8 blocks, during the DCT Transform. CAGI locates grid alignment abnormalities in a JPEG compressed image bitmap, as an indicator of possible forgery. Multiple grid positions are investigated in order to maximize a fitting function. Areas of lower contribution are recognized as grid discontinuities (possible tampering). An image segmentation step is introduced to differentiate between discontinuities produced by tampering and those that are attributed to image content, clearing the output maps by suppressing non-relevant activations. The higher readability of the maps comes with a cost in the form of coarser-grained detection results, more so for low resolution images. CAGI-Inversed accounts for tampering scenarios where the discontinuities appear as areas of averagely higher contribution. The suppression of non-relevant activations is inversed during the image segmentation step, and an alternative output maps is produced. The user can then estimate the most appropriate output based on visual inspection.	Les artefacts de blocage JPEG apparaissent comme un motif régulier de limites de bloc visibles dans une image compressée JPEG, résultant de la quantification des coefficients et du traitement indépendant des blocs 8x8 ne se chevauchant pas, au cours de la transformation DCT. CAGI localise les anomalies d'alignement de la grille dans une image bitmap compressée JPEG, en tant qu'indicateur de falsification possible. Plusieurs positions de la grille sont étudiées afin de maximiser une fonction d’ajustement. Les zones à faible contribution sont reconnues comme des discontinuités du réseau (possibilité de falsification). Une étape de segmentation d’image est introduite pour différencier les discontinuités générées par une altération de celles associées au contenu de l’image, en effaçant les cartes de sortie en supprimant les activations non pertinentes. La lisibilité accrue des cartes a un coût sous la forme de résultats de détection à grain plus grossier, plus particulièrement pour les images à faible résolution. Comptes CAGI-Inversed pour les scénarios de sabotage dans lesquels les discontinuités apparaissent comme des zones de contribution moyenne supérieure. La suppression des activations non pertinentes est inversée au cours de l'étape de segmentation de l'image et une carte de sortie alternative est produite. L'utilisateur peut ensuite estimer le résultat le plus approprié en fonction d'un contrôle visuel.	Los artefactos de bloque JPEG aparecen como un patrón regular de límites de bloques visibles en una imagen comprimida JPEG, como resultado de la cuantificación de los coeficientes y el procesamiento independiente de los bloques no superpuestos de 8x8, durante la Transformación DCT. CAGI localiza las anomalías de alineación de la rejilla en un mapa de bits de imágenes comprimidas en JPEG, como un indicador de una posible falsificación. Se investigan múltiples posiciones de rejilla para maximizar una función de ajuste. Las áreas de menor contribución se reconocen como discontinuidades de la red (posible alteración). Se introduce un paso de segmentación de imágenes para diferenciar entre las discontinuidades producidas por la manipulación y las que se atribuyen al contenido de la imagen, borrando los mapas de salida mediante la supresión de las activaciones no relevantes. La mayor legibilidad de los mapas tiene un coste en forma de resultados de detección de grano más grueso, más aún en el caso de las imágenes de baja resolución. CAGI-Inversed contabiliza los escenarios de manipulación en los que las discontinuidades aparecen como áreas de contribución media más elevada. La supresión de las activaciones no relevantes se invierte durante el paso de segmentación de la imagen, y se producen mapas de salida alternativos. El usuario puede entonces estimar la salida más apropiada basada en la inspección visual.
forensic_card_gridsInversedReport	JPEG Blocking artifacts appear as a regular pattern of visible block boundaries in a JPEG compressed image, as a result of the quantization of the coefficients and the independent processing of the non-overlapping 8x8 blocks, during the DCT Transform. CAGI locates grid alignment abnormalities in a JPEG compressed image bitmap, as an indicator of possible forgery. Multiple grid positions are investigated in order to maximize a fitting function. Areas of lower contribution are recognized as grid discontinuities (possible tampering). An image segmentation step is introduced to differentiate between discontinuities produced by tampering and those that are attributed to image content, clearing the output maps by suppressing non-relevant activations. The higher readability of the maps comes with a cost in the form of coarser-grained detection results, more so for low resolution images. CAGI-Inversed accounts for tampering scenarios where the discontinuities appear as areas of averagely higher contribution. The suppression of non-relevant activations is inversed during the image segmentation step, and an alternative output maps is produced. The user can then estimate the most appropriate output based on visual inspection.	Les artefacts de blocage JPEG apparaissent comme un motif régulier de limites de bloc visibles dans une image compressée JPEG, résultant de la quantification des coefficients et du traitement indépendant des blocs 8x8 ne se chevauchant pas, au cours de la transformation DCT. CAGI localise les anomalies d'alignement de la grille dans une image bitmap compressée JPEG, en tant qu'indicateur de falsification possible. Plusieurs positions de la grille sont étudiées afin de maximiser une fonction d’ajustement. Les zones à faible contribution sont reconnues comme des discontinuités du réseau (possibilité de falsification). Une étape de segmentation d’image est introduite pour différencier les discontinuités générées par une altération de celles associées au contenu de l’image, en effaçant les cartes de sortie en supprimant les activations non pertinentes. La lisibilité accrue des cartes a un coût sous la forme de résultats de détection à grain plus grossier, plus particulièrement pour les images à faible résolution. Comptes CAGI-Inversed pour les scénarios de sabotage dans lesquels les discontinuités apparaissent comme des zones de contribution moyenne supérieure. La suppression des activations non pertinentes est inversée au cours de l'étape de segmentation de l'image et une carte de sortie alternative est produite. L'utilisateur peut ensuite estimer le résultat le plus approprié en fonction d'un contrôle visuel.	Los artefactos de bloque JPEG aparecen como un patrón regular de límites de bloques visibles en una imagen comprimida JPEG, como resultado de la cuantificación de los coeficientes y el procesamiento independiente de los bloques no superpuestos de 8x8, durante la Transformación DCT. CAGI localiza las anomalías de alineación de la rejilla en un mapa de bits de imágenes comprimidas en JPEG, como un indicador de una posible falsificación. Se investigan múltiples posiciones de rejilla para maximizar una función de ajuste. Las áreas de menor contribución se reconocen como discontinuidades de la red (posible alteración). Se introduce un paso de segmentación de imágenes para diferenciar entre las discontinuidades producidas por la manipulación y las que se atribuyen al contenido de la imagen, borrando los mapas de salida mediante la supresión de las activaciones no relevantes. La mayor legibilidad de los mapas tiene un coste en forma de resultados de detección de grano más grueso, más aún en el caso de las imágenes de baja resolución. CAGI-Inversed contabiliza los escenarios de manipulación en los que las discontinuidades aparecen como áreas de contribución media más elevada. La supresión de las activaciones no relevantes se invierte durante el paso de segmentación de la imagen, y se producen mapas de salida alternativos. El usuario puede entonces estimar la salida más apropiada basada en la inspección visual.
forensic_card_dwNoiseReport	High-frequency noise patterns can be used for splicing detection, as the local noise variance of an image is often unique and distinctive. This method detects the local variance of high-frequency information on an image. In the resulting output maps, whether values are high or low is irrelevant. What is significant is the presence of localized consistent differences in noise variance values. Since high-frequency noise can be affected by the image content, comparisons should be made between visually similar areas (e.g. edges to edges, smooth areas to smooth areas). Methods based on noise patterns are not particularly precise, and unless extremely clear patterns appear, this algorithm should be used in conjunction with other detectors.	Les modèles de bruit haute fréquence peuvent être utilisés pour la détection d'épissure, car la variance de bruit local d'une image est souvent unique et distinctive. Cette méthode détecte la variance locale des informations haute fréquence sur une image. Dans les cartes de sortie résultantes, le fait que les valeurs soient hautes ou basses importe peu. Ce qui est significatif, c’est la présence de différences cohérentes localisées dans les valeurs de variance du bruit. Étant donné que le contenu de l'image peut affecter le bruit haute fréquence, il convient de comparer les zones visuellement similaires (par exemple, bords à bords, zones lisses à zones lisses). Les méthodes basées sur les modèles de bruit ne sont pas particulièrement précises et, sauf si des modèles extrêmement clairs apparaissent, cet algorithme doit être utilisé conjointement avec d'autres détecteurs.	Los patrones de ruido de alta frecuencia se pueden utilizar para la detección de empalmes, ya que la variación de ruido local de una imagen es a menudo única y distintiva. Este método detecta la variación local de la información de alta frecuencia en una imagen. En los mapas de salida resultantes, es irrelevante si los valores son altos o bajos. Lo que es significativo es la presencia de diferencias consistentes localizadas en los valores de variación de ruido. Dado que el ruido de alta frecuencia puede verse afectado por el contenido de la imagen, se deben hacer comparaciones entre áreas visualmente similares (por ejemplo, de bordes a bordes, de áreas lisas a áreas lisas). Los métodos basados en patrones de ruido no son particularmente precisos y, a menos que aparezcan patrones extremadamente claros, este algoritmo debe utilizarse junto con otros detectores.
forensic_card_blockingReport	JPEG blocking artifact inconsistencies are traces left when tampering JPEG images by splicing, copy-moving or inpainting. JPEG compression is based on a non-overlapping grid of adjacent blocks of 8×8 pixels. Any part of an image that has undergone at least one JPEG compression carries a blocking trace of this dimension, and its presence is stronger at lower JPEG qualities. When performing any forgery, it is highly likely that the 8×8 grid of the spliced or moved area will misalign with the rest of the image and leave a visible trace. The outputs of this algorithm are often noisy, and are occasionally activated by high-variance image content, so an investigator should look for inconsistencies in regions that should be uniform.	Les incohérences d'artefact bloquant JPEG sont des traces laissées lors de la modification d'images JPEG par épissure, déplacement de copie ou application de peinture. La compression JPEG est basée sur une grille non superposée de blocs adjacents de 8 × 8 pixels. Toute partie d'une image ayant subi au moins une compression JPEG porte une trace de blocage de cette dimension et sa présence est plus forte aux qualités JPEG inférieures. Lors de la falsification, il est fort probable que la grille 8 × 8 de la zone épissée ou déplacée ne corresponde pas au reste de l'image et laisse une trace visible. Les sorties de cet algorithme sont souvent bruitées et sont parfois activées par un contenu d'image à variance élevée. Un enquêteur doit donc rechercher les incohérences dans les régions qui devraient être uniformes.	Las inconsistencias de los artefactos de bloque de JPEG son rastros que quedan cuando se manipulan imágenes JPEG empalmando, copiando, moviendo o pintando. La compresión JPEG se basa en una cuadrícula no superpuesta de bloques adyacentes de 8×8 píxeles. Cualquier parte de una imagen que haya sufrido al menos una compresión JPEG lleva una traza de bloqueo de esta dimensión, y su presencia es más fuerte en calidades JPEG más bajas. Al realizar cualquier falsificación, es muy probable que la cuadrícula de 8×8 del área empalmada o movida se desalinee con el resto de la imagen y deje un rastro visible. Las salidas de este algoritmo son a menudo ruidosas, y se activan ocasionalmente por el contenido de imágenes de alta variación, por lo que un investigador debe buscar inconsistencias en regiones que deberían ser uniformes.
forensic_card_ghostReport	JPEG ghosts are based on the premise that, when a splice is taken from a JPEG image and placed in another one of different quality, traces of the original JPEG compression are carried over. In order to detect them, the image is recompressed in all possible quality levels, and each result is subtracted from the original. If the image contains a splice, a "Ghost" (i.e. a gap) should appear at the quality level that the splice was originally compressed. In reality, Ghosts often appear as regions of high difference, in contrast to the rest of the image. This approach is vulnerable to variations in image content, as high localized differences due to edges will appear at various quality levels. However, an entire localized region -corresponding to a scene object- that stands out in contrast to the entire rest of the image, is a very strong indicator of tampering. As the algorithm outputs a large number of result maps, we only display those having a high probability of containing meaningful results. Still, it is almost certain that only a subset of all the maps displayed for a single image will contain any useful information.	Les fantômes JPEG sont basés sur le principe que, lorsqu'une épissure est prise à partir d'une image JPEG et placée dans une autre de qualité différente, les traces de la compression JPEG d'origine sont conservées. Afin de les détecter, l'image est recompressée dans tous les niveaux de qualité possibles et chaque résultat est soustrait de l'original. Si l’image contient une épissure, un «Ghost» (c’est-à-dire un espace) doit apparaître au niveau de qualité auquel l’épissure a été compressée à l’origine. En réalité, les fantômes apparaissent souvent comme des zones de grande différence, contrairement au reste de l'image. Cette approche est vulnérable aux variations du contenu de l'image, car de grandes différences localisées dues aux contours apparaîtront à différents niveaux de qualité. Cependant, toute une région localisée - correspondant à un objet de scène - qui se démarque du reste de l’image, est un très bon indicateur de falsification. Comme l'algorithme génère un grand nombre de cartes de résultats, nous affichons uniquement celles qui ont une forte probabilité de contenir des résultats significatifs. Néanmoins, il est presque certain que seul un sous-ensemble de toutes les cartes affichées pour une seule image contiendra des informations utiles.	Los fantasmas JPEG se basan en la premisa de que, cuando se toma un empalme de una imagen JPEG y se coloca en otra de diferente calidad, se transfieren los rastros de la compresión JPEG original. Para detectarlos, la imagen se recomprime en todos los niveles de calidad posibles, y cada resultado se resta del original. Si la imagen contiene un empalme, debe aparecer un "Fantasma" (es decir, un hueco) en el nivel de calidad en el que el empalme fue comprimido originalmente. En realidad, los fantasmas aparecen a menudo como regiones de gran diferencia, en contraste con el resto de la imagen. Este enfoque es vulnerable a las variaciones en el contenido de la imagen, ya que las grandes diferencias localizadas debidas a los bordes aparecerán en varios niveles de calidad. Sin embargo, toda una región localizada -que corresponde a un objeto de escena- que destaca en contraste con el resto de la imagen, es un indicador muy fuerte de manipulación. Como el algoritmo produce un gran número de mapas de resultados, sólo mostramos aquellos que tienen una alta probabilidad de contener resultados significativos. Aún así, es casi seguro que sólo un subconjunto de todos los mapas mostrados para una sola imagen contendrá información útil.
survey_loading	Loading...	Chargement en cours...	
about_title	InVID toolkit	Outils InVID	Herramientas InVID
about_lang	Choose language: 	Choisissez la langue:  	Elegir idioma: 
footer_analysis	Provided by <a href="https://www.certh.gr/root.en.aspx">ITI CERTH</a><br>To contact us, use the feedback tool.	Fourni par le <a href="https://www.certh.gr/root.en.aspx">ITI CERTH</a><br>Pour nous contacter, utilisez l'outil de feedback.	Proporcionado por <a href="https://www.certh.gr/root.en.aspx">ITI CERTH</a><br>Para ponerse en contacto con nosotros, utilice la herramienta de feedback.
footer_keyframes	Provided by <a href="https://www.certh.gr/root.en.aspx">ITI CERTH</a><br>To contact us, use the feedback tool.	Fourni par le <a href="https://www.certh.gr/root.en.aspx">ITI CERTH</a><br>Pour nous contacter, utilisez l'outil de feedback.	Proporcionado por <a href="https://www.certh.gr/root.en.aspx">ITI CERTH</a><br>Para ponerse en contacto con nosotros, utilice la herramienta de feedback.
footer_thumbnails	Provided by <a href="https://www.afp.com/fr/lagence/medialab">AFP Medialab</a><br>To contact us, use the feedback tool.	Fourni par le <a href="https://www.afp.com/fr/lagence/medialab">Medialab de l'AFP</a><br>Pour nous contacter, utilisez l'outil de feedback.	Proporcionado por <a href="https://www.afp.com/fr/lagence/medialab">AFP Medialab</a><br>Para ponerse en contacto con nosotros, utilice la herramienta de feedback.
footer_twitter	Provided by <a href="https://www.afp.com/fr/lagence/medialab">AFP Medialab</a><br>To contact us, use the feedback tool.	Fourni par le <a href="https://www.afp.com/fr/lagence/medialab">Medialab de l'AFP</a><br>Pour nous contacter, utilisez l'outil de feedback.	Proporcionado por <a href="https://www.afp.com/fr/lagence/medialab">AFP Medialab</a><br>Para ponerse en contacto con nosotros, utilice la herramienta de feedback.
footer_magnifier	Provided by <a href="https://www.afp.com/fr/lagence/medialab">AFP Medialab</a><br>To contact us, use the feedback tool.	Fourni par le <a href="https://www.afp.com/fr/lagence/medialab">Medialab de l'AFP</a><br>Pour nous contacter, utilisez l'outil de feedback.	Proporcionado por <a href="https://www.afp.com/fr/lagence/medialab">AFP Medialab</a><br>Para ponerse en contacto con nosotros, utilice la herramienta de feedback.
footer_metadata	Provided by the <a href="https://www.afp.com/fr/lagence/medialab">AFP Medialab</a><br>To contact us, use the feedback tool.	Fourni par le <a href="https://www.afp.com/fr/lagence/medialab">Medialab de l'AFP</a><br>Pour nous contacter, utilisez l'outil de feedback.	Proporcionado por el <a href="https://www.afp.com/fr/lagence/medialab">AFP Medialab</a><br>Para ponerse en contacto con nosotros, utilice la herramienta de feedback.
footer_rights	Provided by the GRIHO Research Group © 2018 Universitat de Lleida<br>Contact: <a href="mailto:invid@udl.cat">invid@udl.cat</a>	Fourni par le groupe de recherche GRIHO © 2018 Universitat de Lleida<br>Contact: <a href="mailto:invid@udl.cat">invid@udl.cat</a>	Proporcionado por el Grupo de Investigación GRIHO © 2018 Universitat de Lleida<br>Contactar: <a href="mailto:invid@udl.cat">invid@udl.cat</a>
footer_forensic	Provided by the <a href="https://www.certh.gr/root.en.aspx">ITI CERTH</a>Computer Science Institute<br>To contact us, use the feedback tool.	Fourni par le <a href="https://www.certh.gr/root.en.aspx">ITI CERTH</a><br>Pour nous contacter, utilisez l'outil de feedback.	Proporcionado por el <a href="https://www.certh.gr/root.en.aspx">ITI CERTH</a>Computer Science Institute<br>Para ponerse en contacto con nosotros, utilice la herramienta de comentarios.
footer_about	Provided by the <a href="https://www.afp.com/fr/lagence/medialab">AFP Medialab</a><br>To contact us, use the feedback tool.	Fourni par le <a href="https://www.afp.com/fr/lagence/medialab">Medialab de l'AFP</a><br>Pour nous contacter, utilisez l'outil de feedback.	Proporcionado por el <a href="https://www.afp.com/fr/lagence/medialab">AFP Medialab</a><br>Para ponerse en contacto con nosotros, utilice la herramienta de feedback.
footer_tutorial	Provided by the <a href="https://www.afp.com/fr/lagence/medialab">AFP Medialab</a><br>To contact us, use the feedback tool.	Fourni par le <a href="https://www.afp.com/fr/lagence/medialab">Medialab de l'AFP</a><br>Pour nous contacter, utilisez l'outil de feedback.	Proporcionado por el <a href="https://www.afp.com/fr/lagence/medialab">AFP Medialab</a><br>Para ponerse en contacto con nosotros, utilice la herramienta de feedback.
about_1	This toolkit is provided in open source (under an <a href="license.html" target="_blank">MIT Licence</a>) by the InVID european project to help journalists to verify content on social networks (please note that external InVID services used via this interface, such as those presented under the Analysis and Keyframes tabs, are not open-sourced).	Cet outil est publié en open source (sous une <a href="license.html" target="_blank">Licence MIT</a>) par le projet européen InVID pour aider les journalistes à vérifier les images et les vidéos, notamment sur les réseaux sociaux (note: certains des services externes d'InVID utilisés par cette interface, comme ceux présentés dans les onglets Analyse et Images clés, ne sont pas diffusés en licence open source).	Se proporciona este conjunto de herramientas en código abierto (bajo una <a href="license.html" target="_blank">licencia MIT</a>) por el proyecto europeo InVID para ayudar a los periodistas a verificar el contenido de las redes sociales (tenga en cuenta que los servicios InVID externos utilizados a través de esta interfaz, como los que se presentan en las pestañas Analisis e Imágenes claves, no son de código abierto).
about_2	It has been designed as a verification “Swiss army knife” helping journalists to save time and be more efficient in their fact-checking tasks. This is a beta version and we will update it regularly thanks to your feedback.	Il a été conçu comme un "couteau suisse" de vérification pour permettre les journalistes à gagner du temps et être plus efficaces dans leur travail de vérification. C'est une version en développement et elle sera mise à jour régulièrement grâce à vos retours.	Se ha diseñado como una "navaja suiza" de verificación que ayuda a los periodistas a ahorrar tiempo y a ser más eficientes en sus tareas de verificación de hechos. Esta es una versión beta y la actualizaremos regularmente gracias a sus comentarios.
about_3	For any feedback (bugs, enhancement, suggestions) please email us at <a href="mailto:invid-verification-plugin@iti.gr">invid-verification-plugin@iti.gr</a>, or leave us a direct message through the feedback widget at the bottom left. If you use our plugin regularly, thanks to give us your feedback through the permanent survey in the top right menu :  <img src="img/survey_img_en.png" class="icon" style="vertical-align: text-top;">	Pour tout retour (problèmes, améliorations, suggestions), merci de nous envoyer un mail à <a href="mailto:invid-verification-plugin@iti.gr">invid-verification-plugin@iti.gr</a>, ou de nous laisser un message via le bouton "feedback" en bas à gauche. Si vous utilisez notre extension régulièrement, merci de nous envoyer vos retours en remplissant le questionnaire présent dans le menu en haut à droite :  <img src="img/survey_img_fr.png" class="icon" style="vertical-align: text-top;">	Para cualquier comentario (errores, mejoras, sugerencias) por favor envíenos un correo electrónico a <a href="mailto:invid-verification-plugin@iti.gr">invid-verification-plugin@iti.gr</a>, o déjenos un mensaje directo a través del widget de comentarios en la parte inferior izquierda. Si usted usa nuestro plugin regularmente, gracias por darnos su opinión a través de la encuesta permanente en el menú superior derecho:  <img src="img/survey_img_en.png" class="icon" style="vertical-align: text-top;">
about_4	<strong>Disclaimer:</strong> this software is provided "as is", without warranty of any kind, express or implied, including but not limited to the warranties of merchantability, fitness for a particular purpose and noninfringement. In no event shall the authors or copyright holders be liable for any claim, damages or other liability, whether in an action of contract, tort or otherwise, arising from, out of or in connection with the software or the use or other dealings in the software.	<strong>Avertissement:</strong> ce logiciel est fourni tel quel, sans aucune garantie explicite ou implicite, y compris mais non limité à sa qualité marchande, sa robustesse et toute garantie d'absence de contrefaçon. En aucun cas, les auteurs ou détenteurs du copyright ne sont responsables pour toute réclamation, dommages ou autre responsabilité, en lien avec ce logiciel ou son utilisation.	<strong>Descarga de responsabilidad:</strong> Este software se proporciona "tal cual", sin garantía de ningún tipo, expresa o implícita, incluyendo pero no limitándose a las garantías de comerciabilidad, idoneidad para un propósito particular y no infracción. En ningún caso los autores o titulares de los derechos de autor serán responsables de ninguna reclamación, daño u otra responsabilidad, ya sea en una acción contractual, extracontractual o de otro tipo, que surja de o en relación con el software o el uso u otras transacciones en el software.
about_5	<strong>Privacy:</strong> this plugin does not gather any personal data. We implemented Google analytics only to get feedback and statistics about the tool usage, in order to improve the next releases.	<strong>Sécurité:</strong> cette extension n'utilise pas vos données personnelles. Les données récupérées via Google Analytics sont anonymisées et ne servent qu'à obtenir des statistiques d'usage sur l'utilisation de l'extension, dans le but d'améliorer les prochaines versions.	<strong>Privacidad:</strong> este plugin no recoge ningún dato personal. Implementamos Google Analytics sólo para obtener estadísticas sobre el uso de la herramienta, con el fin de mejorar las próximas versiones.
about_6	InVID is a Horizon 2020 innovation action funded by the European Union under grant agreement 687786. For more information, visit our <a href="http://www.invid-project.eu/" target="_blank">InVID website</a> or follow us on <a href="https://twitter.com/InVID_EU" target="_blank">Twitter</a>.	InVID est un projet financé par le programme Horizon 2020 de l'Union Européenne, sous l'accord de subvention 687786. Pour plus d'information sur le projet, visitez le <a href="http://www.invid-project.eu/" target="_blank"> site InVID</a> ou suivez-nous sur <a href="https://twitter.com/InVID_EU" target="_blank">Twitter</a>.	InVID es una acción de innovación financiada por el programa cuadro Horizonte 2020 de la Unión Europea bajo el acuerdo de subvención 687786. Para más información, visite nuestra página web <a href="http://www.invid-project.eu/" target="_blank">InVID website</a> o síganos en <a href="https://twitter.com/InVID_EU" target="_blank">Twitter</a>.
about_7	The initial versions (0.1-0.6) of this plugin have been developed by <a href="https://www.afp.com/en/medialab/" target="_blank">AFP Medialab</a> (Denis TEYSSOU, Jean-Michel LEUNG, Nathan GOYAT, Bertrand GOUPIL, Axel VIGNY). The underlying services are provided by <a href="http://mklab.iti.gr/" target="_blank">Thessaloniki Information Technologies Institute</a> (ITI, CERTH).	Les premières versions (0.1-0.6) de cette extension ont été développées par le <a href="https://www.afp.com/medialab/" target="_blank">Medialab de l'AFP</a> (Denis TEYSSOU, Jean-Michel LEUNG, Nathan GOYAT, Bertrand GOUPIL, Axel VIGNY). Les services sous-jacents sont fournis par <a href="http://mklab.iti.gr/" target="_blank">Thessaloniki Information Technologies Institute</a> (ITI, CERTH).	Las primeras versiones (0.1-0.6) de esta extensión han sido desarrolladas por el <a href="https://www.afp.com/medialab/" target="_blank">Medialab de AFP</a> (Denis TEYSSOU, Jean-Michel LEUNG, Nathan GOYAT, Bertrand GOUPIL, Axel VIGNY). Los servicios sub-yacentes son prestados por <a href="http://mklab.iti.gr/" target="_blank">Thessaloniki Information Technologies Institute</a> (ITI, CERTH).
about_human_rights	For Human Rights defenders	Pour les défenseurs des Droits de l'Homme	Para los defensores de los Derechos Humanos
tuto_title	Tutorial	Tutoriel	Tutorial
tuto_h_1	Access menu	Menu Popup	Menú de accesso
tuto_h_2	Plugin main features	Principales fonctionnalités de l'extension	Principales funciones de la extensión
tuto_1	This launcher (introduced in v0.60) to access the InVID plugin aims to help journalists (and users) to retrieve videos and images urls within the code of a web page:	Ce menu intermédiaire (introduit dans la v0.60) pour accéder à l'outil InVID vise à aider les journalistes (et utilisateurs) à récupérer les liens des images et vidéos à l'intérieur du code d'une page web:	Este menú iniciador (introducido en la v0.60) para acceder a la extensión tiene como objetivo ayudar a los periodistas (y a los usuarios) a recuperar los enlaces de las imágenes y videos dentro del código de una página web:
tuto_2	<li><strong>Open InVID</strong> launches the plugin</li><li><strong>Video Urls</strong> displays the url of a video present on a web page</li><li><strong>Image Urls</strong> displays the url of an image present on a web page</li>	<li><strong>Open InVID</strong> ouvre l'extension InVID</li><li><strong>Video Urls</strong> affiche les urls des vidéos présentes dans la page web</li><li><strong>Image Urls</strong> affiche les urls des images présentes dans la page web</li>	<li><strong>Open InVID</strong> lanza el plugin</li><li><strong>Video Urls</strong> muestra la url de un vídeo presente en una página web </li><li><strong>Image Urls</strong> muestra la url de una imagen presente en una página web </li>
tuto_3	Here, below, is an example of a video url retrieval on Instagram.	En dessous se trouve un exemple de la récupération d'urls vidéo sur Instagram.	A continuación se muestra un ejemplo de recuperación de una url de vídeo en Instagram.
tuto_4	The first <strong>Analysis tab</strong> allows you to query the InVID context aggregation and analysis service developed by the <a href="http://mklab.iti.gr/" target="_blank">Thessaloniki Information Technologies Institute</a> (ITI). In a nutshell, this service is an enhanced metadata viewer for Youtube, Facebook and Twitter videos that allows you to retrieve contextual information, location (if detected), most interesting comments, apply reverse image search and check for tweets on the video (on Youtube). Be aware that the service may take some time if the video processed has a lot of comments. A new feature (a reprocess button) allows you to refresh the analysis.	Le premier onglet <strong>Analyse</strong>  vous permet d'effectuer des requêtes sur le service aggregation et analyse d'InVID développé par <a href="http://mklab.iti.gr/" target="_blank">Thessaloniki Information Technologies Institute</a> En simplifié, ce service est un visonneur de métadonnées amélioré pour les vidéo Youtube , Facebook et Twitter, qui vous permet de récupérer les informations contextuelles, localisations (si détecté), la plupart des commentaires intéressants, d'appliquer la recherche d'image inversée et de vérifier les tweets correspondants à la vidéo (pour Youtube). Soyez conscient que le service peut prendre du temps si la vidéo possède beaucoup de commentaires. Une nouvelle fonction (le bouton reprocess) vous permet de rafraichir l'analyse.	La primera pestaña <strong>Análisis</strong> permite consultar el servicio de agregación y análisis de contexto InVID desarrollado por el <a href="http://mklab.iti.gr/" target="_blank">Thessaloniki Information Technologies Institute</a> (ITI). En pocas palabras, este servicio es un visor de metadatos mejorado para vídeos de Youtube, Facebook y Twitter que le permite recuperar información contextual, ubicación (si se detecta), comentarios más interesantes, aplicar la búsqueda inversa de imágenes y comprobar si hay tweets en el vídeo (en YouTube). Tenga en cuenta que el servicio puede tardar algún tiempo si el vídeo procesado tiene muchos comentarios. Una nueva característica (un botón de reprocesamiento) le permite actualizar el análisis.
tuto_5	The second <strong>Keyframe tab</strong> is an iframe opening the website of <a href="http://mklab.iti.gr/" target="_blank">Thessaloniki Information Technologies Institute (ITI) </a> on video fragmentation. It allows you to copy a video url (from Youtube, Twitter, Facebook, Daily Motion or Dropbox) or to upload a video file (in mp4, webm, avi, mov, wmv, ogv, mpg, flv, and mkv format) in order to segment it in keyframes which then can be searched with a right click on Google, Yandex, Tineye and Baidu images. Our service extracts more keyframes and therefore gives the opportunity to enhance the video reverse image search. Those are the real keyframes of the video, not the thumbnails served by Youtube or Facebook.	Le second onglet <strong>Images clés</strong> est une iframe contenant le site de <a href="http://mklab.iti.gr/" target="_blank">Thessaloniki Information Technologies Institute (ITI) </a> sur la fragmentation vidéo. Il vous permet en copiant une adresse vidéo (Youtube, Twitter, Facebook, Daily Motion, Instagram or Dropbox) ou en téléchargeant un fichier vidéo (mp4, webm, avi, mov, wmv, ogv, mpg, fly, ou mkv) de le fragmenter en images clés qui peuvent être ensuite recherchées avec un clic droit sur Google, Yandex, Tineye ou Baidu image. Notre service peut extraire davantage d'images clés et donc vous donne l'opportunité d'élargir votre recherche inversée d'image. Ces images viennent de la vidéo elle-même, non des imagettes fournies par la plateforme vidéo.	La segunda pestaña <strong>Imágenes claves</strong> le permite copiar una url de vídeo (de Youtube, Twitter, Facebook, Daily Motion o Dropbox) para segmentarlo en fotogramas clave que luego se pueden buscar con un clic derecho en Google, Yandex, Tineye, Baidu, Bing o Karma Decay (Reddit). Nuestro servicio extrae más fotogramas clave y, por lo tanto, ofrece la oportunidad de mejorar la búsqueda de imágenes inversas de vídeo. Esos son los fotogramas clave reales del vídeo, no las miniaturas servidas por Youtube, Twitter o Facebook. También pueden subir un archivo de vídeo (en formato mp4, webm, avi, mov, wmv, ogv, mpg, flv, y mkv) usando el botón fichero local y aparecerá el sitio web de <a href="http://mklab.iti.gr/" target="_blank">Thessaloniki Information Technologies Institute (ITI) </a> sobre fragmentación de vídeo en un iframe.
tuto_6	The <strong>Thumbnails tab</strong> allows you to quickly trigger a reverse image search on Google, Bing, Tineye or Yandex Images with the four thumbnails extracted from a Youtube video. Up to four tabs (according to the number of thumbnails available) are opened automatically in your browser with the results of the reverse search while the four thumbnails are also displayed in the plugin page. This tab is somewhat redundant with what can be done with the <strong>Analysis tab</strong> but it is very fast and efficient if you just need to look whether a Youtube video has already been published previously. Please note that the Chinese search engine Baidu is not implemented here because it is filtering out Youtube content.	L'onglet <strong>Imagettes</strong>  vous permet de faire rapidement une recherche d'image inversée sur Google, Bing, Yandex ou Tineye avec les quatre imagettes fournies par Youtube sur ces vidéos. Jusqu'à quatre onglets (selon le nombre de imagettes disponibles) sont ouverts automatiquement dans votre navigateur avec les résultats de la recherche inversée pendant que les imagettes sont également affichées dans l'extension. Cet onglet est quelque peu redondant avec ce qui peut être fait dans l'onglet Analyse mais il est plus rapide et efficace si vous avez juste besoin de regarder si une vidéo de Youtube a déjà été publiée précédemment. Noter que la recherche avec le moteur Baidu n'est pas configurée dans cet onglet car ce moteur chinois filtre le contenu de Youtube.	La pestaña <strong>Miniaturas</strong> le permite activar rápidamente una búsqueda inversa de imágenes en Google, Bing, Tineye o Yandex Images con las cuatro miniaturas extraídas de un vídeo de YouTube. Se abren automáticamente hasta cuatro pestañas (según el número de miniaturas disponibles) en su navegador con los resultados de la búsqueda inversa, mientras que las cuatro miniaturas también se muestran en la página del plugin. Esta pestaña es algo redundante con lo que se puede hacer con la pestaña <strong>Análisis</strong> pero es muy rápida y eficiente si sólo necesitas ver si un vídeo de Youtube ya ha sido publicado anteriormente. Tenga en cuenta que el motor de búsqueda chino Baidu no está implementado aquí porque está filtrando el contenido de YouTube.
tuto_7	The <strong>Search tab</strong> allows to enhance a Twitter advanced search for keywords or hashtag using the since and until operators, either separately or together to query within a time interval, up to the minute. It translates automatically the calendar date, hour and minutes into an unix timestamp to facilitate the query, e.g. of first eyewitness pictures or videos within a time range just after a breaking news event. We have also added other features from Twitter advanced such geocode, near, from, language and various filter operators.	L'onglet <strong>Recherche Tw</strong> vous permet d'améliorer votre recherche avancée sur Twitter par mot clé ou hashtag en utilisant les opérateurs depuis et jusqu'à, de manière séparée ou ensemble, pour effectuer des requêtes precises jusqu'à un intervalle d'une minute. Il traduit automatiquement les dates calendaires, heures et minutes en unités de temps Unix pour faciliter l'écriture de la requête, par exemple recherche les premiers témoignages photos ou vidéos lors d'un évènement important. Nous avons également ajouté d'autres filtres, comme les coordonnées de géolocalisation, la provenance, le compte Twitter, la langue...	La pestaña <strong>Buscar</strong> permite mejorar una búsqueda avanzada en Twitter de palabras clave o hashtag usando el desde y hasta que los operadores, ya sea por separado o en conjunto para consultar dentro de un intervalo de tiempo, hasta el minuto. Convierte automáticamente la fecha del calendario, la hora y los minutos en una marca de tiempo unix para facilitar la consulta, por ejemplo, de las imágenes o vídeos de los primeros testigos oculares dentro de un intervalo de tiempo justo después de un evento de noticias de última hora. También hemos añadido otras características de Twitter avanzadas como geocode, near, from, language y varios operadores de filtros.
tuto_8	The <strong>Magnifier lens tab</strong> allows you to display an image through its url and to zoom or apply a magnifying lens on the image, or/and to enhance it through a bicubic algorithm to help you discover implicit knowledge such as written words, signs, banners ... You can either enter the image url, upload an image from your local drive with the local file button. Once the image is displayed from an url, you can also perform a Google, Yandex, Tineye and Baidu reverse image search on it or use the Image forensic service designed by ITI and DW in the <a href="https://revealproject.eu/" target="_blank">Reveal european project</a>. If you are using a local image or you have modified any image (sharp, flip, bicubic), you can either download your modified image or, if using the flip function, use the Google images button which opens a new tab where you can directly copy and paste the image into the Google images searchbox (watch the video below). This Magnifier lens feature also supports links of stored images in Dropbox and Google drive.	L'onglet <strong>Loupe</strong> vous permet d'afficher une image partir de son url et de zoomer ou d'utiliser une loupe sur l'image pour aider à découvrir des éléments dans l'image comme du texte, des signes, pancartes... Vous pouvez aussi agrandir l'image grâce à un algorithme bicubic. Pour utiliser cette fonctionnalité, vous pouvez soit entrer l'adresse de l'image, soit charger une image depuis votre ordinateur grâce au bouton fichier local. Quand l'image est fournie depuis une adresse en ligne, vous pouvez également effectuer une recherche d'image inversée avec Google, Yandex, Tineye ou Baidu sur l'image ou utiliser le service Forensic créé par ITI et DW dans le <a href="https://revealproject.eu/" target="_blank">projet européen Reveal</a>. Si vous utilisez une image locale, ou si vous avez utilisé un filtre, vous pouvez soit télécharger l'image résultante, ou dans le cas du Miroir utiliser le bouton Google image qui s'ouvre dans un nouvel onglet de votre navigateur (voir la vidéo en dessous). Cette fonctionnalité de Loupe supporte également les liens d'images stockées sous Dropbox et Google Drive.	La pestaña <strong>Lupa </strong> le permite mostrar una imagen a través de su url y hacer zoom o aplicar una lente de aumento a la imagen, y/o mejorarla a través de un algoritmo bicúbico para ayudarle a descubrir el conocimiento implícito como palabras escritas, signos, banners.... Puede introducir la url de la imagen, subir una imagen desde su disco local con el botón de archivo local. Una vez que la imagen se muestra desde una url, también puede realizar una búsqueda inversa de imágenes en Google, Yandex, Tineye y Baidu o utilizar el servicio forense de imágenes. Si utiliza una imagen local o ha modificado cualquier imagen (nítida, volteada, bicúbica), puede descargar la imagen modificada o, si utiliza la función voltear, utilizar el botón Imágenes de Google, que abre una nueva pestaña en la que puede copiar y pegar directamente la imagen en el cuadro de búsqueda de imágenes de Google (vea el vídeo que aparece a continuación). Esta función de lente de aumento también admite enlaces de imágenes almacenadas en Dropbox y en la unidad de Google.
tuto_9	The <strong>Metadata tab</strong> allows you to check the Exif metadata of a picture in jpeg format or metadata of a vidéo in mp4/m4v format, either through a link either through a local file. If geocoordinates are available in the picture metadata, a geolocalise button is provided automatically pointing to this location on Google map.	L'onglet <strong>Métadonnées</strong> vous permet de vérifier les métadonnées Exif d'une image au format Jpeg ou les métadonnées d'une vidéo au format mp4/m4v, soit par l'adresse en ligne (url) soit en la chargeant depuis un fichier local. Si des coordonées sont trouvées dans les métadonnées de l'image, un bouton de géolocalisation apparait renvoyant vers la carte Google Map correspondante.	La pestaña <strong>Metadatos</strong> permite comprobar los metadatos Exif de una imagen en formato jpeg o los metadatos de un vídeo en formato mp4/m4v, ya sea a través de un enlace o a través de un archivo local. Si las coordenadas geográficas están disponibles en los metadatos de imagen, se proporciona un botón de geolocalización que apunta automáticamente a esta ubicación en el mapa de Google.
tuto_10	The <strong>Video Rights</strong> tab provides access to the InVID Rights Management application. This service gets a link to a YouTube, Facebook or Twitter video and retrieves metadata about its rights, unless access is restricted by the content uploader or the social network. First of all it provides the user with a summary of the reuse conditions, as defined by the social network the video is published in. If other reuses are intended, it is recommended to contact the content uploader. This can be done directly or under the guidance of the <a href="https://rights.invid.udl.cat/" target="_blank">InVID Rights Management Tool</a>. The latter facilitates contacting the uploader, confirming authorship, or managing the negotiation of the reuse conditions. Alternatively, the Video Rights tab includes information about copyright exceptions if it is not possible to get consent from the author, as the use by the press exception or fair use/fair dealing.	L'onglet <strong>Droits Vidéo</strong> donne accès à l'application de gestion des droits d'InVID. Ce service permet, à partir du lien d'une vidéo de Youtube, Facebook ou Twitter de récupérer les métadonnées sur ses droits d'utilisation en fonction de la licence, à moins que l'accès ne soit restreint par le réseau social ou le contributeur. Le service fournit d'abord un résumé des conditions de ré-utilisation de la vidéo, tel que défini par le réseau social. Si d'autres utilisations sont envisagées, il est recommandé de contacter la personne qui a mis le contenu sur le réseau social. Ce contact peut être fait directement ou bien via <a href="https://rights.invid.udl.cat/" target="_blank">l'outil InVID de gestion de droits</a>. Ce dernier facilite le contact avec le contributeur, la confirmation de la propriété du contenu, ou la gestion de la négociation pour les conditions de réutilisation. Cette fonctionnalité inclut en outre des informations sur les exceptions au copyright, au cas où il ne serait pas possible d'obtenir le consentement de l'auteur, comme l'utilisation dans un contexte journalistique ou l'utilisation loyale ("fair use").	La pestaña <strong>Derechos Video</strong> proporciona acceso a la aplicación InVID Rights Management. Este servicio obtiene un enlace a un vídeo de YouTube, Facebook o Twitter y recupera metadatos sobre sus derechos, a menos que el acceso esté restringido por el cargador de contenido o la red social. En primer lugar, proporciona al usuario un resumen de las condiciones de reutilización, definidas por la red social en la que se publica el vídeo. Si se prevén otros usos, se recomienda ponerse en contacto con el cargador de contenido. Esto se puede hacer directamente o bajo la guía del <a href="https://rights.invid.udl.cat/" target="_blank">InVID Rights Management Tool</a>. Esto último facilita el contacto con el cargador, la confirmación de la autoría o la gestión de la negociación de las condiciones de reutilización. Alternativamente, la pestaña Derechos de vídeo incluye información sobre excepciones a los derechos de autor si no es posible obtener el consentimiento del autor, como el uso por parte de la prensa o el uso legítimo/trato justo.
tuto_11	The <strong>Forensic tab</strong> is an iframe opening the still images forensic service developed by <a href="http://mklab.iti.gr/" target="_blank">Thessaloniki Information Technologies Institute (ITI)</a> in a previous european project on social media verification, <a href="https://revealproject.eu/" target="_blank">Reveal</a>. Eight different filters will help you to detect digital image tampering.	L'onglet <strong>Forensic</strong> est une iframe contenant le service d'imagerie forensic développé par <a href="http://mklab.iti.gr/" target="_blank">Thessaloniki Information Technologies Institute (ITI)</a> dans un projet européen précedent sur la vérification des réseaux sociaux, <a href="https://revealproject.eu/" target="_blank">Reveal</a>. Huit filtres vous aideront à détecter des manipulations de l'image numérique.	La pestañal <strong>Forensic</strong> le permite copiar y pegar una url de imagen en jpg o png y enviarla al servicio de Forensic (detección de alteraciones en el fichero digital). Ocho filtros diferentes le ayudarán a detectar la manipulación de las imágenes digitales. Si desea cargar un archivo de imagen, puede hacer clic en el botón de archivo local y el sitio web del <a href="http://mklab.iti.gr/" target="_blank">Thessaloniki Information Technologies Institute (ITI)</a> aparecerá en un iframe. Este servicio ha sido desarrollado en un proyecto europeo anterior sobre verificación de medios sociales: <a href="https://revealproject.eu/" target="_blank">REVEAL</a>. 
tuto_12	The <strong>Contextual menu</strong> (through a right click on an image or a video url) allows you to trigger this plugin on a still image or on a youtube video link. On an image, a right click will propose you either to open the picture in the Image magnifier to examine it more closely, or to launch reverse image search engines with the image. On a video link, a right click will propose you under the InVID menu to trigger either InVID video analysis or the Youtube thumbnail reverse search (for a Youtube video).	Le <strong>Menu contextuel</strong> (appui sur le clic droit de la souris sur une image, une video ou une adresse vers une image ou video) vous permet d'envoyer directement une image ou une video sur l'extension. Avec une image, vous pourrez ouvrir l'image dans le magnifier ou de lancer une recherche d'image inversée. Sur une vidéo, vous pourrez envoyer la vidéo dans les onglets <strong>Analyse</strong> ou <strong>Youtube imagettes</strong> si elle correspond aux critères de l'onglet souhaité.	El <strong>Menú contextual </strong> (a través de un clic derecho sobre una imagen o una url de vídeo) le permite activar este plugin en una imagen fija o en un enlace de vídeo de YouTube. En una imagen, un clic derecho le propondrá abrir la imagen en el magnificador de imagen para examinarla más de cerca, o bien lanzar motores de búsqueda de imagen inversa con la imagen. En un enlace de vídeo, un clic derecho le propondrá en el menú InVID para activar el análisis de vídeo InVID o la búsqueda inversa de miniaturas en Youtube (para un vídeo de Youtube).
navbar_tools	Tools	Outils	Herramientas
navbar_classroom	Classroom	Salle de cours	Aula
third_parties_title	Third parties tools we love	Autres outils que nous apprécions	Otras herramientas que nos gustan
close	Close	Fermer	Cerrar
display	Display	Afficher	Visualización
remote_resources_title	 Educational Resources	Ressources pédagogiques	Recursos educativos
user_resources_title	 Your educational content	Votre contenu pédagogique	Tu contenido educativo
form_to_display_your_own_lessons	Use this form to display your own lessons	Utilisez ce formulaire pour afficher vos propres leçons	Usa este formulario para mostrar tus propias lecciones
user_resources_intro	This section allows you to broadcast your own lessons stored on Internet	Cette section vous permet de diffuser vos propres cours stockés sur Internet.	Esta sección le permite transmitir sus propios videos de Internet.
user_resources_intro_local	Select a mp4 video on your computer	Sélectionnez une vidéo au format mp4 sur votre ordinateur	Seleccione un video mp4 en su computadora
user_resources_intro_remote	Enter the url of a youtube or facebook video:	Indiquez l'url d'une vidéo youtube ou facebook:	O ingresa la url de un video de youtube o facebook:
menu_cro_tit	CrowdTangle	CrowdTangle	CrowdTangle
menu_cml_tit	CMLA	CMLA	CMLA
menu_cro_dsc	Crowd tangle	Crowd tangle	Crowd tangle
menu_cml_dsc	Cmla	Cmla	Cmla
footer_classroom	Provided by the <a href="https://www.afp.com/fr/lagence/medialab">AFP Medialab</a><br>To contact us, use the feedback tool.	Fourni par le <a href="https://www.afp.com/fr/lagence/medialab">Medialab de l'AFP</a><br>Pour nous contacter, utilisez l'outil de feedback.	Proporcionado por <a href="https://www.afp.com/fr/lagence/medialab">AFP Medialab</a><br>Para ponerse en contacto con nosotros, utilice la herramienta de feedback.
classroom_title	Classroom	Salle de cours	Aula
classroom_title_1	How to verify a video	Vérifier une image par similarité	Analisis forensic de una imagen
classroom_embed_1	<iframe src="https://docs.google.com/presentation/d/e/2PACX-1vSRSuLowKGhmGHa0w5v-e9hl0OH552R5oG7tdJzRFgwsdPYEJnPLJuUQ_hZ0WGu2lWe6evkdgYKLuGp/embed?start=true&loop=true&delayms=3000" frameborder="0" width="960" height="569" allowfullscreen="true" mozallowfullscreen="true" webkitallowfullscreen="true"></iframe>	<iframe src="https://docs.google.com/presentation/d/e/2PACX-1vTK7t7DQm4HJLwxY7nFP08xITqzZZFsWaoe7g9R9o0vH2IpDeqDnYelyfuUuHV9Tk5U6K25wxC869oZ/embed?start=true&loop=true&delayms=5000" frameborder="0" width="960" height="569" allowfullscreen="true" mozallowfullscreen="true" webkitallowfullscreen="true"></iframe>	<iframe src="https://docs.google.com/presentation/d/e/2PACX-1vTt6s8UUG0WwaCF1fuaDZ8tGt5tnP-vXkKgv5tz6lysa3nshFZm4PGr4GD721tgjEKtG7lhHdTU7r2q/embed?start=true&loop=true&delayms=5000" frameborder="0" width="960" height="569" allowfullscreen="true" mozallowfullscreen="true" webkitallowfullscreen="true"></iframe>
classroom_title_2	How to check a video on Facebook (source: France 24)	Comment vérifier une vidéo sur Facebook (source: France 24)	Cómo ver un video en Facebook (fuente: Francia 24)
classroom_embed_2	<blockquote class="twitter-tweet" data-lang="en"><p lang="fr" dir="ltr">INFO ✅ ou INTOX ❌ Vérifier une vidéo sur Facebook, c&#39;est l&#39;un des exercices le plus difficile du <a href="https://twitter.com/hashtag/factchecking?src=hash&amp;ref_src=twsrc%5Etfw">#factchecking</a>... dans cet épisode <a href="https://twitter.com/alexcapron?ref_src=twsrc%5Etfw">@alexcapron</a> vous présente un outil de vérification vidéo gratuit utilisé par la rédaction des <a href="https://twitter.com/Observateurs?ref_src=twsrc%5Etfw">@Observateurs</a> de <a href="https://twitter.com/France24_fr?ref_src=twsrc%5Etfw">@France24_fr</a> : <a href="https://twitter.com/InVID_EU?ref_src=twsrc%5Etfw">@InVID_EU</a> <a href="https://t.co/TGEv7JVUau">pic.twitter.com/TGEv7JVUau</a></p>&mdash; Les Observateurs (@Observateurs) <a href="https://twitter.com/Observateurs/status/1056829241663225856?ref_src=twsrc%5Etfw">October 29, 2018</a></blockquote><script async src="https://platform.twitter.com/widgets.js" charset="utf-8"></script>	<blockquote class="twitter-tweet" data-lang="en"><p lang="fr" dir="ltr">INFO ✅ ou INTOX ❌ Vérifier une vidéo sur Facebook, c&#39;est l&#39;un des exercices le plus difficile du <a href="https://twitter.com/hashtag/factchecking?src=hash&amp;ref_src=twsrc%5Etfw">#factchecking</a>... dans cet épisode <a href="https://twitter.com/alexcapron?ref_src=twsrc%5Etfw">@alexcapron</a> vous présente un outil de vérification vidéo gratuit utilisé par la rédaction des <a href="https://twitter.com/Observateurs?ref_src=twsrc%5Etfw">@Observateurs</a> de <a href="https://twitter.com/France24_fr?ref_src=twsrc%5Etfw">@France24_fr</a> : <a href="https://twitter.com/InVID_EU?ref_src=twsrc%5Etfw">@InVID_EU</a> <a href="https://t.co/TGEv7JVUau">pic.twitter.com/TGEv7JVUau</a></p>&mdash; Les Observateurs (@Observateurs) <a href="https://twitter.com/Observateurs/status/1056829241663225856?ref_src=twsrc%5Etfw">October 29, 2018</a></blockquote><script async src="https://platform.twitter.com/widgets.js" charset="utf-8"></script>	<blockquote class="twitter-tweet" data-lang="en"><p lang="fr" dir="ltr">INFO ✅ ou INTOX ❌ Vérifier une vidéo sur Facebook, c&#39;est l&#39;un des exercices le plus difficile du <a href="https://twitter.com/hashtag/factchecking?src=hash&amp;ref_src=twsrc%5Etfw">#factchecking</a>... dans cet épisode <a href="https://twitter.com/alexcapron?ref_src=twsrc%5Etfw">@alexcapron</a> vous présente un outil de vérification vidéo gratuit utilisé par la rédaction des <a href="https://twitter.com/Observateurs?ref_src=twsrc%5Etfw">@Observateurs</a> de <a href="https://twitter.com/France24_fr?ref_src=twsrc%5Etfw">@France24_fr</a> : <a href="https://twitter.com/InVID_EU?ref_src=twsrc%5Etfw">@InVID_EU</a> <a href="https://t.co/TGEv7JVUau">pic.twitter.com/TGEv7JVUau</a></p>&mdash; Les Observateurs (@Observateurs) <a href="https://twitter.com/Observateurs/status/1056829241663225856?ref_src=twsrc%5Etfw">October 29, 2018</a></blockquote><script async src="https://platform.twitter.com/widgets.js" charset="utf-8"></script>
classroom_title_3			
classroom_embed_3			
classroom_title_4			
classroom_embed_4			
classroom_title_5			
classroom_embed_5			
api_help_video			
keyframes_help_video	https://www.youtube.com/embed/kh7S2A6hPpg	https://www.youtube.com/embed/kh7S2A6hPpg	https://www.youtube.com/embed/kh7S2A6hPpg
thumbnails_help_video	https://www.youtube.com/embed/kh7S2A6hPpg	https://www.youtube.com/embed/kh7S2A6hPpg	https://www.youtube.com/embed/kh7S2A6hPpg
twitter_help_video	https://www.youtube.com/embed/kh7S2A6hPpg	https://www.youtube.com/embed/kh7S2A6hPpg	https://www.youtube.com/embed/kh7S2A6hPpg
magnifier_help_video	https://www.youtube.com/embed/kh7S2A6hPpg	https://www.youtube.com/embed/kh7S2A6hPpg	https://www.youtube.com/embed/kh7S2A6hPpg
metadata_help_video	https://www.youtube.com/embed/kh7S2A6hPpg	https://www.youtube.com/embed/kh7S2A6hPpg	https://www.youtube.com/embed/kh7S2A6hPpg
copyright_help_video	https://www.youtube.com/embed/kh7S2A6hPpg	https://www.youtube.com/embed/kh7S2A6hPpg	https://www.youtube.com/embed/kh7S2A6hPpg
forensic_help_video	https://www.youtube.com/embed/kh7S2A6hPpg	https://www.youtube.com/embed/kh7S2A6hPpg	https://www.youtube.com/embed/kh7S2A6hPpg
crowd_help_video	https://www.youtube.com/embed/kh7S2A6hPpg	https://www.youtube.com/embed/kh7S2A6hPpg	https://www.youtube.com/embed/kh7S2A6hPpg
cmla_help_video	https://www.youtube.com/embed/kh7S2A6hPpg	https://www.youtube.com/embed/kh7S2A6hPpg	https://www.youtube.com/embed/kh7S2A6hPpg
api_help_content	English content of analysis help	Contenu français du service analyse	Contenido en francés del servicio de análisis
keyframes_help_content			
thumbnails_help_content			
twitter_help_content			
magnifier_help_content			
metadata_help_content			
copyright_help_content			
forensic_help_content	English content of Forensic help	Contenu français du service Forensic	Contenido en francés del servicio de Forensic
crowd_help_content			
cmla_help_content			
